Unit,Way,Keel_Date,Delivery_Date,Yard_Cost, Procurement_Cost,Facilities_Cost,Admin_Cost,TC,VC,FC,Yard,Direct_Hours,Indirect_Hours,Total_ManHours,Way_Days,Outfitting_Days,Total_Production_Days
1,1,4/30/41,12/30/41,1613203,888165,88815,25666,2615849,2501368,114481,Bethlehem,870870,327818,1198688,150,94,244
2,2,5/15/41,1/19/42,1545574,888165,86414,24972,2545125,2433739,111386,Bethlehem,831745,313916,1145661,163,86,249
3,3,6/21/41,1/29/42,1470687,888165,83755,24204,2466811,2358852,107959,Bethlehem,788406,308175,1096581,147,75,222
4,4,6/21/41,2/9/42,1421123,888165,81995,23695,2414978,2309288,105690,Bethlehem,758934,293346,1052280,168,65,233
5,5,7/15/41,2/20/42,1397852,888165,81169,23457,2390643,2286017,104626,Bethlehem,735197,283848,1019045,144,76,220
6,6,7/15/41,2/27/42,1354256,888165,79621,23009,2345051,2242421,102630,Bethlehem,710342,271138,981480,168,59,227
8,8,8/25/41,3/30/42,1267658,888165,76546,22121,2254490,2155823,98667,Bethlehem,668785,241103,909888,174,43,217
9,9,9/3/41,3/18/42,1151856,888165,77226,22316.5914,2139563.591,2040021,99542.5914,Bethlehem,675662,248713,924375,143,53,196
10,10,9/12/41,4/11/42,1236111,888165,75426,21796.5714,2221498.571,2124276,97222.5714,Bethlehem,652911,231234,884145,163,48,211
11,11,9/22/41,5/9/42,1236111,888165,72434,20932.1826,2217642.183,2124276,93366.1826,Bethlehem,603625,194216,797841,187,42,229
12,1,9/27/41,3/13/42,1277991,888165,76913,22226.1657,2265295.166,2166156,99139.1657,Bethlehem,669066,247255,916321,119,48,167
13,12,10/13/41,4/27/42,1186664,888165,73670,21289.263,2169788.263,2074829,94959.263,Bethlehem,623944,209301,833245,152,44,196
14,13,10/20/41,5/16/42,1147240,888165,72270,20884.803,2128559.803,2035405,93154.803,Bethlehem,607450,194143,801593,174,34,208
15,2,10/29/41,4/17/42,1204048,888165,74287,21467.5143,2187967.514,2092213,95754.5143,Bethlehem,636509,218486,854995,122,48,170
16,14,11/5/41,5/29/42,1110199,888165,70955,20504.8995,2089823.9,1998364,91459.8995,Bethlehem,585715,177228,762943,176,29,205
17,3,11/19/41,4/30/42,1172827,888165,73179,21147.4131,2155318.413,2060992,94326.4131,Bethlehem,619694,204628,824322,115,47,162
18,5,12/10/41,4/23/42,1177161,888165,73333,21191.9037,2159850.904,2065326,94524.9037,Bethlehem,618363,207616,825979,84,50,134
19,4,12/10/41,5/12/42,1140510,888165,72031,20815.7559,2121521.756,2028675,92846.7559,Bethlehem,601081,191226,792307,115,38,153
20,15,12/13/41,6/19/42,1065198,888165,69357,20043.2373,2042763.237,1953363,89400.2373,Bethlehem,556260,156869,713129,168,20,188
21,16,12/13/41,7/11/42,1068694,888165,69481,20079.0609,2046419.061,1956859,89560.0609,Bethlehem,546704,153488,700192,194,16,210
22,6,1/6/42,5/5/42,1142364,888165,72097,20834.8233,2123460.823,2030529,92931.8233,Bethlehem,603135,192317,795452,81,38,119
23,7,1/6/42,5/20/42,1111815,888165,71013,20521.6557,2091514.656,1999980,91534.6557,Bethlehem,588102,178831,766933,96,38,134
24,9,1/28/42,5/23/42,1108418,888165,70892,20486.6988,2087961.699,1996583,91378.6988,Bethlehem,587029,178252,765281,89,26,115
25,1,1/28/42,5/27/42,1103958,888165,70734,20441.0526,2083298.053,1992123,91175.0526,Bethlehem,585240,175559,760799,85,34,119
26,8,2/18/42,6/2/42,1077145,888165,69782,20166.0198,2055258.02,1965310,89948.0198,Bethlehem,570574,163486,734060,77,27,104
27,10,2/25/42,6/8/42,1066754,888165,69413,20059.4157,2044391.416,1954919,89472.4157,Bethlehem,562945,158855,721800,78,25,103
28,2,3/4/42,6/5/42,1066058,888165,69388,20052.1932,2043663.193,1954223,89440.1932,Bethlehem,564478,158549,723027,68,25,93
29,5,3/9/42,6/10/42,1065146,888165,69356,20042.9484,2042709.948,1953311,89398.9484,Bethlehem,560884,157901,718785,70,23,93
30,12,3/18/42,6/16/42,1056310,888165,69038,19951.0782,2033464.078,1944475,88989.0782,Bethlehem,554282,153054,707336,65,25,90
31,3,3/18/42,6/13/42,1056089,888165,69034,19949.9226,2033237.923,1944254,88983.9226,Bethlehem,554884,152909,707793,65,22,87
32,6,3/31/42,6/22/42,1051644,888165,68876,19904.2764,2028589.276,1939809,88780.2764,Bethlehem,548640,150633,699273,65,18,83
33,11,3/31/42,6/29/42,1049905,888165,68814,19886.3646,2026770.365,1938070,88700.3646,Bethlehem,544943,149604,694547,75,15,90
34,4,4/6/42,6/26/42,1046826,888165,68705,19854.8745,2023550.875,1934991,88559.8745,Bethlehem,546066,148024,694090,63,18,81
35,13,4/14/42,7/6/42,1052507,888165,68907,19913.2323,2029492.232,1940672,88820.2323,Bethlehem,544209,149978,694187,65,18,83
36,7,4/14/42,6/30/42,1046847,888165,68706,19855.1634,2023573.163,1935012,88561.1634,Bethlehem,542017,147752,689769,61,16,77
37,1,4/25/42,7/7/42,1054457,888165,68976,19933.1664,2031531.166,1942622,88909.1664,Bethlehem,542519,149693,692212,58,15,73
38,9,4/29/42,7/13/42,1063145,888165,69284,20022.1476,2040616.148,1951310,89306.1476,Bethlehem,538819,149046,687865,58,17,75
39,14,5/2/42,7/18/42,1074509,888165,69688,20138.8632,2052500.863,1962674,89826.8632,Bethlehem,533755,148721,682476,63,14,77
40,8,5/8/42,7/21/42,1072020,888165,69600,20113.44,2049898.44,1960185,89713.44,Bethlehem,534851,148695,683546,57,17,74
41,2,5/13/42,7/24/42,1071644,888165,69586,20109.3954,2049504.395,1959809,89695.3954,Bethlehem,530827,146530,677357,52,20,72
42,10,5/15/42,7/25/42,1075325,888165,69717,20147.2413,2053354.241,1963490,89864.2413,Bethlehem,530745,146587,677332,56,15,71
43,5,5/19/42,7/28/42,1075921,888165,69738,20153.3082,2053977.308,1964086,89891.3082,Bethlehem,529786,146583,676369,55,15,70
44,3,5/24/42,7/29/42,1079705,888165,69872,20192.0208,2057934.021,1967870,90064.0208,Bethlehem,529513,146638,676151,52,14,66
45,12,5/24/42,7/31/42,1086227,888165,70104,20259.0456,2064755.046,1974392,90363.0456,Bethlehem,528678,146731,675409,62,6,68
46,15,6/1/42,7/30/42,1088696,888165,70192,20284.4688,2067337.469,1976861,90476.4688,Bethlehem,528003,146616,674619,51,8,59
47,6,6/6/42,8/8/42,1086055,888165,70098,20257.3122,2064575.312,1974220,90355.3122,Bethlehem,525670,147253,672923,53,10,63
48,4,6/10/42,8/10/42,1084000,888165,70025,20236.2225,2062426.223,1972165,90261.2225,Bethlehem,522711,147627,670338,51,10,61
49,11,6/15/42,8/17/42,1078710,888165,69837,20181.9093,2056893.909,1966875,90018.9093,Bethlehem,518430,148358,666788,52,11,63
50,7,6/15/42,8/21/42,1075732,888165,69731,20151.2859,2053779.286,1963897,89882.2859,Bethlehem,516183,148743,664926,56,11,67
51,13,6/20/42,8/18/42,1081434,888165,69934,20209.9326,2059742.933,1969599,90143.9326,Bethlehem,517708,148490,666198,48,11,59
52,1,6/24/42,8/25/42,1074809,888165,69699,20142.0411,2052815.041,1962974,89841.0411,Bethlehem,512788,148853,661641,52,10,62
53,16,6/27/42,8/27/42,1077718,888165,69802,20171.7978,2055856.798,1965883,89973.7978,Bethlehem,509530,149151,658681,52,9,61
54,9,6/28/42,8/29/42,1079098,888165,69851,20185.9539,2057299.954,1967263,90036.9539,Bethlehem,509826,149170,658996,52,10,62
55,8,7/5/42,8/31/42,1076481,888165,69758,20159.0862,2054563.086,1964646,89917.0862,Bethlehem,506511,149672,656183,51,6,57
56,2,7/6/42,9/5/42,1075184,888165,69712,20145.7968,2053206.797,1963349,89857.7968,Bethlehem,505705,149661,655366,46,15,61
57,14,7/6/42,9/9/42,1071570,888165,69584,20108.8176,2049427.818,1959735,89692.8176,Bethlehem,503400,149583,652983,52,13,65
58,10,7/11/42,9/14/42,1068439,888165,69472,20076.4608,2046152.461,1956604,89548.4608,Bethlehem,501475,149572,651047,51,14,65
59,5,7/14/42,9/10/42,1071549,888165,69583,20108.5287,2049405.529,1959714,89691.5287,Bethlehem,502907,149216,652123,45,13,58
60,3,7/16/42,9/14/42,1065106,888165,69354,20042.3706,2042667.371,1953271,89396.3706,Bethlehem,499374,149517,648891,46,14,60
61,15,7/23/42,9/16/42,1060017,888165,69173,19990.0797,2037345.08,1948182,89163.0797,Bethlehem,496237,149492,645729,46,9,55
62,12,7/28/42,9/19/42,1056991,888165,69067,19959.4563,2034182.456,1945156,89026.4563,Bethlehem,494603,149637,644240,41,12,53
63,6,7/30/42,9/22/42,1042994,888165,68569,19815.5841,2019543.584,1931159,88384.5841,Bethlehem,493974,149338,643312,39,15,54
64,4,8/2/42,9/24/42,1042919,888165,68566,19814.7174,2019464.717,1931084,88380.7174,Bethlehem,490456,149525,639981,42,11,53
65,11,8/8/42,9/26/42,1044622,888165,68627,19832.3403,2021246.34,1932787,88459.3403,Bethlehem,489386,149926,639312,42,7,49
66,13,8/9/42,9/30/42,1045796,888165,68668,19844.1852,2022473.185,1933961,88512.1852,Bethlehem,489300,150096,639396,43,9,52
67,7,8/11/42,9/30/42,1045728,888165,68666,19843.6074,2022402.607,1933893,88509.6074,Bethlehem,489218,150099,639317,42,8,50
68,16,8/19/42,10/7/42,1047783,888165,68739,19864.6971,2024551.697,1935948,88603.6971,Bethlehem,488270,150574,638844,38,11,49
69,14,8/29/42,10/17/42,1053202,888165,68931,19920.1659,2030218.166,1941367,88851.1659,Bethlehem,486442,151913,638355,42,7,49
70,15,9/8/42,10/23/42,1057253,888165,69075,19961.7675,2034454.768,1945418,89036.7675,Bethlehem,485134,152945,638079,32,13,45
71,13,9/23/42,10/31/42,1059986,888165,69172,19989.7908,2037312.791,1948151,89161.7908,Bethlehem,483018,154105,637123,31,7,38
72,16,9/28/42,11/10/42,1060049,888165,69175,19990.6575,2037379.658,1948214,89165.6575,Bethlehem,480518,153705,634223,33,10,43
73,15,10/11/42,11/27/42,1061559,888165,69228,20005.9692,2038957.969,1949724,89233.9692,Bethlehem,473838,152920,626758,28,19,47
74,14,10/12/42,11/30/42,1061765,888165,69235,20007.9915,2039172.992,1949930,89242.9915,Bethlehem,473260,152757,626017,31,18,49
75,13,10/26/42,12/8/42,1064910,888165,69347,20040.3483,2042462.348,1953075,89387.3483,Bethlehem,472562,152442,625004,30,13,43
76,16,11/2/42,12/15/42,1065158,888165,69356,20042.9484,2042721.948,1953323,89398.9484,Bethlehem,472062,151867,623929,26,17,43
77,15,11/10/42,12/21/42,1071114,888165,69567,20103.9063,2048949.906,1959279,89670.9063,Bethlehem,474265,151940,626205,27,14,41
78,14,11/14/42,12/30/42,1073324,888165,69646,20126.7294,2051261.729,1961489,89772.7294,Bethlehem,475975,151951,627926,35,11,46
79,13,11/26/42,1/19/43,1072856,888165,69629,20121.8181,2050771.818,1961021,89750.8181,Bethlehem,471735,152344,624079,44,10,54
80,16,11/29/42,1/11/43,1076324,888165,69752,20157.3528,2054398.353,1964489,89909.3528,Bethlehem,477568,152293,629861,29,14,43
81,12,12/2/42,1/15/43,1077871,888165,69807,20173.2423,2056016.242,1966036,89980.2423,Bethlehem,477058,152331,629389,26,18,44
82,11,12/7/42,2/6/43,1074665,888165,69693,20140.3077,2052663.308,1962830,89833.3077,Bethlehem,468082,152565,620647,45,16,61
83,3,12/7/42,1/28/43,1075897,888165,69737,20153.0193,2053952.019,1964062,89890.0193,Bethlehem,470559,152585,623144,39,13,52
84,15,12/9/42,1/31/43,1075088,888165,69709,20144.9301,2053106.93,1963253,89853.9301,Bethlehem,468215,152716,620931,40,13,53
85,9,12/12/42,2/22/43,1074267,888165,69679,20136.2631,2052247.263,1962432,89815.2631,Bethlehem,466809,152317,619126,49,23,72
86,6,12/14/42,2/11/43,1074617,888165,69692,20140.0188,2052614.019,1962782,89832.0188,Bethlehem,467291,152498,619789,42,17,59
87,4,12/15/42,2/23/43,1073858,888165,69665,20132.2185,2051820.219,1962023,89797.2185,Bethlehem,465776,152280,618056,53,17,70
88,7,12/15/42,2/17/43,1074208,888165,69677,20135.6853,2052185.685,1962373,89812.6853,Bethlehem,466349,152368,618717,44,20,64
89,14,12/22/42,2/15/43,1073496,888165,69652,20128.4628,2051441.463,1961661,89780.4628,Bethlehem,464375,152420,616795,45,10,55
90,8,12/22/42,2/28/43,1073464,888165,69651,20128.1739,2051408.174,1961629,89779.1739,Bethlehem,465074,151913,616987,53,15,68
91,1,12/24/42,3/2/43,1073397,888165,69648,20127.3072,2051337.307,1961562,89775.3072,Bethlehem,464702,151973,616675,50,18,68
92,16,12/31/42,2/26/43,1073483,888165,69652,20128.4628,2051428.463,1961648,89780.4628,Bethlehem,464521,152152,616673,42,15,57
93,12,12/31/42,3/8/43,1071791,888165,69591,20110.8399,2049657.84,1959956,89701.8399,Bethlehem,464222,151287,615509,51,16,67
94,10,1/1/43,3/3/43,1072829,888165,69628,20121.5292,2050743.529,1960994,89749.5292,Bethlehem,464223,151702,615925,48,13,61
95,13,1/11/43,3/6/43,1072492,888165,69616,20118.0624,2050391.062,1960657,89734.0624,Bethlehem,464126,151520,615646,39,15,54
96,5,1/12/43,3/9/43,1071165,888165,69569,20104.4841,2049003.484,1959330,89673.4841,Bethlehem,463638,151033,614671,41,15,56
97,3,1/17/43,3/16/43,1067726,888165,69447,20069.2383,2045407.238,1955891,89516.2383,Bethlehem,462327,149849,612176,43,15,58
98,15,1/20/43,3/13/43,1068684,888165,69481,20079.0609,2046409.061,1956849,89560.0609,Bethlehem,462715,150054,612769,38,14,52
99,11,1/23/43,3/23/43,1065166,888165,69356,20042.9484,2042729.948,1953331,89398.9484,Bethlehem,461247,148995,610242,45,14,59
100,2,1/25/43,4/6/43,1068726,888165,69483,20079.6387,2046453.639,1956891,89562.6387,Bethlehem,462753,150176,612929,44,27,71
101,6,1/27/43,3/18/43,1067101,888165,69425,20062.8825,2044753.883,1955266,89487.8825,Bethlehem,462003,149547,611550,35,15,50
102,7,1/30/43,3/26/43,1063757,888165,69306,20028.5034,2041256.503,1951922,89334.5034,Bethlehem,460732,148488,609220,40,15,55
103,9,1/31/43,3/31/43,1064265,888165,69324,20033.7036,2041787.704,1952430,89357.7036,Bethlehem,460900,148553,609453,38,21,59
104,14,2/6/43,3/22/43,1065435,888165,69330,20035.437,2042965.437,1953600,89365.437,Bethlehem,460872,148587,609459,28,16,44
105,4,2/8/43,3/29/43,1059141,888165,69142,19981.1238,2036429.124,1947306,89123.1238,Bethlehem,458603,147100,605703,38,11,49
106,16,2/13/43,3/29/43,1059735,888165,69169,19988.9241,2037057.924,1947900,89157.9241,Bethlehem,458784,147245,606029,31,13,44
107,1,2/13/43,4/7/43,1054439,888165,68975,19932.8775,2031511.878,1942604,88907.8775,Bethlehem,456627,146091,602718,41,12,53
108,8,2/15/43,3/31/43,1057682,888165,69090,19966.101,2034903.101,1945847,89056.101,Bethlehem,457869,146666,604535,32,12,44
109,10,2/19/43,4/5/43,1054626,888165,68982,19934.8998,2031707.9,1942791,88916.8998,Bethlehem,456580,146026,602606,34,11,45
110,13,2/20/43,4/3/43,1056255,888165,69040,19951.656,2033411.656,1944420,88991.656,Bethlehem,457021,146240,603261,32,10,42
111,12,2/21/43,4/10/43,1048233,888165,68755,19869.3195,2025022.32,1936398,88624.3195,Bethlehem,453662,144813,598475,37,11,48
112,5,2/23/43,4/8/43,1051417,888165,68868,19901.9652,2028351.965,1939582,88769.9652,Bethlehem,454733,145216,599949,32,12,44
113,15,2/28/43,4/12/43,1043924,888165,68602,19825.1178,2020516.118,1932089,88427.1178,Bethlehem,451759,143822,595581,31,12,43
114,2,3/1/43,4/16/43,1037391,888165,68370,19758.093,2013684.093,1925556,88128.093,Bethlehem,449235,142805,592040,37,9,46
115,3,3/2/43,4/22/43,1035456,888165,68301,19738.1589,2011660.159,1923621,88039.1589,Bethlehem,448459,142463,590922,39,12,51
116,6,3/4/43,4/13/43,1040008,888165,68463,19784.9607,2016420.961,1928173,88247.9607,Bethlehem,450190,143111,593301,31,9,40
117,14,3/8/43,4/17/43,1036403,888165,68335,19747.9815,2012650.982,1924568,88082.9815,Bethlehem,448765,142547,591312,30,10,40
118,11,3/10/43,4/22/43,1030304,888165,68118,19685.2902,2006272.29,1918469,87803.2902,Bethlehem,446394,141668,588062,34,9,43
119,9,3/11/43,4/26/43,1029663,888165,68096,19678.9344,2005602.934,1917828,87774.9344,Bethlehem,446132,141574,587706,35,11,46
120,7,3/12/43,4/24/43,1030700,888165,68132,19689.3348,2006686.335,1918865,87821.3348,Bethlehem,446514,141718,588232,32,11,43
121,16,3/17/43,4/27/43,1027656,888165,68024,19658.1336,2003503.134,1915821,87682.1336,Bethlehem,445314,141277,586591,31,10,41
122,4,3/19/43,4/30/43,1023203,888165,67866,19612.4874,1998846.487,1911368,87478.4874,Bethlehem,443590,140640,584230,35,7,42
123,8,3/20/43,4/30/43,1024106,888165,67898,19621.7322,1999790.732,1912271,87519.7322,Bethlehem,443902,140754,584656,33,8,41
124,13,3/25/43,5/1/43,1021133,888165,67793,19591.3977,1996682.398,1909298,87384.3977,Bethlehem,442635,140270,582905,30,7,37
125,10,3/26/43,5/8/43,1019357,888165,67730,19573.197,1994825.197,1907522,87303.197,Bethlehem,440726,139233,579959,34,9,43
126,1,3/27/43,5/10/43,1017604,888165,67667,19554.9963,1992990.996,1905769,87221.9963,Bethlehem,439487,138621,578108,34,10,44
127,5,3/28/43,5/6/43,1018956,888165,67715,19568.8635,1994404.864,1907121,87283.8635,Bethlehem,441130,139545,580675,29,10,39
128,12,3/31/43,5/12/43,1015169,888165,67581,19530.1509,1990445.151,1903334,87111.1509,Bethlehem,437918,137868,575786,34,8,42
129,15,4/1/43,5/26/43,1015609,888165,67597,19534.7733,1990905.773,1903774,87131.7733,Bethlehem,438541,138234,576775,31,24,55
130,6,4/5/43,5/15/43,1014250,888165,67548,19520.6172,1989483.617,1902415,87068.6172,Bethlehem,436986,137368,574354,32,8,40
131,2,4/8/43,5/24/43,892948,888165,63241,18276.3249,1862630.325,1781113,81517.3249,Bethlehem,378021,118580,496601,36,10,46
132,14,4/8/43,5/20/43,1013932,888165,67537,19517.4393,1989151.439,1902097,87054.4393,Bethlehem,436273,136946,573219,33,9,42
133,3,4/11/43,5/20/43,892821,888165,63237,18275.1693,1862498.169,1780986,81512.1693,Bethlehem,378020,118607,496627,32,7,39
134,11,4/13/43,5/26/43,1012816,888165,67497,19505.8833,1987983.883,1900981,87002.8833,Bethlehem,433719,135425,569144,33,10,43
135,7,4/14/43,5/21/43,1012974,888165,67503,19507.6167,1988149.617,1901139,87010.6167,Bethlehem,434146,135686,569832,28,9,37
136,9,4/16/43,5/27/43,1012569,888165,67489,19503.5721,1987726.572,1900734,86992.5721,Bethlehem,433229,135122,568351,32,9,41
137,16,4/18/43,5/27/43,1010981,888165,67432,19487.1048,1986065.105,1899146,86919.1048,Bethlehem,432869,134993,567862,29,10,39
138,8,4/23/43,5/31/43,1009496,888165,67380,19472.082,1984513.082,1897661,86852.082,Bethlehem,430656,133672,564328,29,9,38
139,4,4/24/43,5/31/43,1008584,888165,67347,19462.5483,1983558.548,1896749,86809.5483,Bethlehem,430078,133348,563426,30,7,37
140,13,4/25/43,5/29/43,1007410,888165,67305,19450.4145,1982330.415,1895575,86755.4145,Bethlehem,429853,133236,563089,26,8,34
141,5,4/27/43,5/31/43,1007202,888165,67298,19448.3922,1982113.392,1895367,86746.3922,Bethlehem,429458,133010,562468,24,10,34
142,10,4/30/43,6/9/43,1005850,888165,67250,19434.525,1980699.525,1894015,86684.525,Bethlehem,427878,132034,559912,28,12,40
143,1,5/1/43,6/22/43,1005371,888165,67233,19429.6137,1980198.614,1893536,86662.6137,Bethlehem,427270,131617,558887,30,22,52
144,15,5/3/43,6/10/43,1005089,888165,67223,19426.7247,1979903.725,1893254,86649.7247,Bethlehem,427118,131615,558733,27,11,38
145,12,5/5/43,6/12/43,1004771,888165,67212,19423.5468,1979571.547,1892936,86635.5468,Bethlehem,426868,131442,558310,27,11,38
146,6,5/8/43,6/15/43,1004642,888165,67207,19422.1023,1979436.102,1892807,86629.1023,Bethlehem,426759,131346,558105,25,13,38
147,14,5/12/43,6/16/43,1004355,888165,67197,19419.2133,1979136.213,1892520,86616.2133,Bethlehem,426512,131112,557624,25,10,35
148,7,5/12/43,6/24/43,1004256,888165,67194,19418.3466,1979033.347,1892421,86612.3466,Bethlehem,426404,130952,557356,28,15,43
149,3,5/14/43,6/22/43,1003874,888165,67180,19414.302,1978633.302,1892039,86594.302,Bethlehem,426167,130785,556952,27,12,39
150,2,5/15/43,6/29/43,1003479,888165,67169,19411.1241,1978224.124,1891644,86580.1241,Bethlehem,425893,130552,556445,34,11,45
151,11,5/17/43,6/28/43,1002961,888165,67148,19405.0572,1977679.057,1891126,86553.0572,Bethlehem,425579,130489,556068,25,17,42
152,16,5/18/43,6/25/43,1002348,888165,67126,19398.7014,1977037.701,1890513,86524.7014,Bethlehem,425272,130312,555584,25,13,38
153,9,5/19/43,6/28/43,1002012,888165,67114,19395.2346,1976686.235,1890177,86509.2346,Bethlehem,425030,130111,555141,25,15,40
154,13,5/22/43,6/30/43,1001974,888165,67112,19394.6568,1976645.657,1890139,86506.6568,Bethlehem,424987,130048,555035,28,11,39
155,5,5/22/43,6/30/43,1001928,888165,67111,19394.3679,1976598.368,1890093,86505.3679,Bethlehem,424939,129976,554915,24,15,39
156,8,5/22/43,7/2/43,1001592,888165,67099,19390.9011,1976246.901,1889757,86489.9011,Bethlehem,424855,129931,554786,32,9,41
157,4,5/25/43,7/6/43,999322,888165,67018,19367.5002,1973872.5,1887487,86385.5002,Bethlehem,424270,129602,553872,32,10,42
158,10,5/28/43,7/8/43,996286,888165,66911,19336.5879,1970698.588,1884451,86247.5879,Bethlehem,423250,128997,552247,31,10,41
159,15,5/31/43,7/12/43,994586,888165,66850,19318.965,1968919.965,1882751,86168.965,Bethlehem,422821,128768,551589,29,13,42
160,1,5/31/43,7/20/43,987626,888165,66603,19247.6067,1961641.607,1875791,85850.6067,Bethlehem,421122,127927,549049,41,9,50
161,12,6/1/43,7/12/43,993522,888165,66812,19307.9868,1967806.987,1881687,86119.9868,Bethlehem,422458,128566,551024,29,12,41
162,6,6/2/43,7/14/43,990737,888165,66713,19279.3857,1964894.386,1878902,85992.3857,Bethlehem,421775,128225,550000,32,10,42
163,14,6/6/43,7/19/43,988073,888165,66619,19252.2291,1962109.229,1876238,85871.2291,Bethlehem,421029,127854,548883,34,9,43
164,7,6/9/43,7/26/43,983220,888165,66447,19202.5383,1957034.538,1871385,85649.5383,Bethlehem,419727,127202,546929,37,10,47
165,3,6/10/43,7/28/43,981903,888165,66400,19188.96,1955656.96,1870068,85588.96,Bethlehem,419309,126993,546302,38,10,48
166,11,6/11/43,7/23/43,982798,888165,66432,19198.2048,1956593.205,1870963,85630.2048,Bethlehem,419478,127072,546550,31,11,42
167,16,6/12/43,7/29/43,981838,888165,66398,19188.3822,1955589.382,1870003,85586.3822,Bethlehem,419052,126843,545895,34,13,47
168,9,6/13/43,7/26/43,979914,888165,66329,19168.4481,1953576.448,1868079,85497.4481,Bethlehem,418536,126583,545119,32,11,43
169,5,6/15/43,7/30/43,975966,888165,66189,19128.0021,1949448.002,1864131,85317.0021,Bethlehem,417405,126017,543422,38,7,45
170,2,6/18/43,7/31/43,973004,888165,66084,19097.6676,1946350.668,1861169,85181.6676,Bethlehem,416586,125612,542198,36,7,43
171,13,6/19/43,7/30/43,971999,888165,66048,19087.2672,1945299.267,1860164,85135.2672,Bethlehem,415927,125267,541194,33,8,41
172,8,6/23/43,8/6/43,978245,888165,66270,19151.403,1951831.403,1866410,85421.403,Bethlehem,414719,124571,539290,35,9,44
173,4,6/26/43,8/10/43,919843,888165,64196,18552.2244,1890756.224,1808008,82748.2244,Bethlehem,414842,124369,539211,35,10,45
174,10,6/28/43,7/31/43,913168,888165,63959,18483.7551,1883775.755,1801333,82442.7551,Bethlehem,415300,124757,540057,27,6,33
175,15,6/29/43,8/9/43,917049,888165,64097,18523.6233,1887834.623,1805214,82620.6233,Bethlehem,414639,124315,538954,29,12,41
176,12,6/30/43,8/9/43,917423,888165,64110,18527.379,1888225.379,1805588,82637.379,Bethlehem,414350,124150,538500,29,11,40
177,6,7/4/43,8/12/43,918247,888165,64140,18536.046,1889088.046,1806412,82676.046,Bethlehem,412756,123422,536178,30,9,39
178,14,7/10/43,8/13/43,920577,888165,64222,18559.7358,1891523.736,1808742,82781.7358,Bethlehem,412168,123092,535260,26,8,34
179,1,7/12/43,8/19/43,924256,888165,64353,18597.5817,1895371.582,1812421,82950.5817,Bethlehem,410124,122100,532224,30,8,38
180,11,7/12/43,8/16/43,922497,888165,64291,18579.6699,1893532.67,1810662,82870.6699,Bethlehem,410338,122253,532591,28,7,35
181,9,7/15/43,8/23/43,926879,888165,64446,18624.4494,1898114.449,1815044,83070.4494,Bethlehem,409807,121872,531679,29,10,39
182,16,7/16/43,8/18/43,924462,888165,64446,18624.4494,1895697.449,1812627,83070.4494,Bethlehem,410099,122082,532181,25,8,33
183,7,7/16/43,8/20/43,925977,888165,64414,18615.2046,1897171.205,1814142,83029.2046,Bethlehem,409916,121949,531865,27,8,35
184,3,7/18/43,8/23/43,928964,888165,64520,18645.828,1900294.828,1817129,83165.828,Bethlehem,409553,121690,531243,27,9,36
185,13,7/22/43,8/26/43,931787,888165,64620,18674.718,1903246.718,1819952,83294.718,Bethlehem,409210,121443,530653,27,8,35
186,5,7/23/43,8/27/43,931140,888165,64597,18668.0733,1902570.073,1819305,83265.0733,Bethlehem,408694,121037,529731,27,8,35
187,2,7/24/43,9/2/43,932393,888165,64642,18681.0738,1903881.074,1820558,83323.0738,Bethlehem,407943,120534,528477,32,8,40
188,10,7/25/43,8/30/43,932497,888165,64646,18682.2294,1903990.229,1820662,83328.2294,Bethlehem,407786,120332,528118,27,9,36
189,8,7/28/43,9/3/43,932472,888165,64645,18681.9405,1903963.941,1820637,83326.9405,Bethlehem,407213,120041,527254,29,8,37
190,15,7/28/43,8/30/43,933803,888165,64692,18695.5188,1905355.519,1821968,83387.5188,Bethlehem,407465,120098,527563,25,8,33
191,12,7/29/43,9/1/43,933784,888165,64691,18695.2299,1905335.23,1821949,83386.2299,Bethlehem,407187,119935,527122,26,8,34
192,4,7/31/43,9/6/43,934511,888165,64717,18702.7413,1906095.741,1822676,83419.7413,Bethlehem,406608,119636,526244,28,9,37
193,6,8/3/43,9/8/43,933595,888165,64685,18693.4965,1905138.497,1821760,83378.4965,Bethlehem,406185,119457,525642,28,8,36
194,14,8/5/43,9/7/43,933979,888165,64698,18697.2522,1905539.252,1822144,83395.2522,Bethlehem,406328,119515,525843,25,8,33
195,11,8/9/43,9/11/43,931978,888165,64627,18676.7403,1903446.74,1820143,83303.7403,Bethlehem,405581,119212,524793,25,8,33
196,16,8/10/43,9/12/43,931372,888165,64606,18670.6734,1902813.673,1819537,83276.6734,Bethlehem,405354,119120,524474,25,8,33
197,1,8/11/43,9/18/43,811970,855740,59215,17113.2135,1744038.214,1667710,76328.2135,Bethlehem,350850,103155,454005,32,6,38
198,7,8/12/43,9/15/43,929671,888165,64545,18653.0505,1901034.051,1817836,83198.0505,Bethlehem,404709,118856,523565,25,9,34
199,9,8/13/43,9/16/43,929445,888165,64537,18650.7393,1900797.739,1817610,83187.7393,Bethlehem,404625,118822,523447,25,9,34
200,3,8/14/43,9/15/43,812356,855740,59228,17116.9692,1744440.969,1668096,76344.9692,Bethlehem,350984,103207,454191,26,6,32
201,13,8/18/43,9/20/43,927010,888165,64451,18625.8939,1898251.894,1815175,83076.8939,Bethlehem,403715,118452,522167,24,9,33
202,5,8/19/43,9/20/43,926632,888165,64437,18621.8493,1897855.849,1814797,83058.8493,Bethlehem,403565,118386,521951,25,7,32
203,10,8/21/43,9/24/43,926277,888165,64425,18618.3825,1897485.383,1814442,83043.3825,Bethlehem,403229,118234,521463,26,8,34
204,15,8/22/43,9/23/43,926033,888165,64416,18615.7824,1897229.782,1814198,83031.7824,Bethlehem,403138,118197,521335,24,8,32
205,12,8/24/43,9/27/43,925201,888165,64387,18607.4043,1896360.404,1813366,82994.4043,Bethlehem,402827,118071,520898,25,9,34
206,2,8/25/43,9/29/43,924685,888165,64368,18601.9152,1895819.915,1812850,82969.9152,Bethlehem,402624,117984,520608,27,8,35
207,8,8/26/43,9/27/43,924545,888165,64363,18600.4707,1895673.471,1812710,82963.4707,Bethlehem,402572,117963,520535,24,8,32
208,4,8/28/43,10/1/43,924121,888165,64348,18596.1372,1895230.137,1812286,82944.1372,Bethlehem,402406,117901,520307,25,9,34
209,14,8/30/43,10/2/43,925247,888165,64388,18607.6932,1896407.693,1813412,82995.6932,Bethlehem,402749,118085,520834,24,9,33
210,6,8/31/43,10/4/43,926570,888165,64435,18621.2715,1897791.272,1814735,83056.2715,Bethlehem,403180,118297,521477,25,9,34
211,11,9/3/43,10/5/43,929402,888165,64536,18650.4504,1900753.45,1817567,83186.4504,Bethlehem,404112,118748,522860,23,9,32
212,16,9/4/43,10/6/43,931224,888165,64600,18668.94,1902657.94,1819389,83268.94,Bethlehem,404715,119038,523753,23,9,32
213,7,9/5/43,10/7/43,937141,888165,64810,18729.609,1908845.609,1825306,83539.609,Bethlehem,406276,119775,526051,23,9,32
214,9,9/7/43,10/9/43,938786,888165,64869,18746.6541,1910566.654,1826951,83615.6541,Bethlehem,406820,120037,526857,24,8,32
215,3,9/9/43,10/11/43,946669,888165,65149,18827.5461,1918810.546,1834834,83976.5461,Bethlehem,409425,121294,530719,25,7,32
216,13,9/11/43,10/12/43,946030,888165,65126,18820.9014,1918141.901,1834195,83946.9014,Bethlehem,409214,121192,530406,22,9,31
217,1,9/12/43,10/18/43,958546,888165,65571,18949.4619,1931231.462,1846711,84520.4619,Bethlehem,413321,123164,536485,28,8,36
218,5,9/13/43,10/13/43,953137,888165,65378,18893.7042,1925573.704,1841302,84271.7042,Bethlehem,411456,122250,533706,23,7,30
219,15,9/15/43,10/15/43,956974,888165,65515,18933.2835,1929587.284,1845139,84448.2835,Bethlehem,412674,122821,535495,23,7,30
220,10,9/16/43,10/18/43,959609,888165,65608,18960.1512,1932342.151,1847774,84568.1512,Bethlehem,413394,123127,536521,23,9,32
221,12,9/18/43,10/18/43,967516,888165,65889,19041.3321,1940611.332,1855681,84930.3321,Bethlehem,415958,124348,540306,23,7,30
222,8,9/19/43,10/21/43,965923,888165,65832,19024.8648,1938944.865,1854088,84856.8648,Bethlehem,415140,123920,539060,23,9,32
223,2,9/21/43,10/27/43,845141,855740,60393,17453.5377,1778727.538,1700881,77846.5377,Bethlehem,359947,107492,467439,27,9,36
224,4,9/22/43,10/25/43,973238,888165,66092,19099.9788,1946594.979,1861403,85191.9788,Bethlehem,417030,124768,541798,23,10,33
225,14,9/23/43,10/25/43,975792,888165,66183,19126.2687,1949266.269,1863957,85309.2687,Bethlehem,417873,125176,543049,23,9,32
226,6,9/25/43,10/27/43,977727,888165,66252,19146.2028,1951290.203,1865892,85398.2028,Bethlehem,418511,125485,543996,22,10,32
227,11,9/26/43,10/28/43,979333,888165,66309,19162.6701,1952969.67,1867498,85471.6701,Bethlehem,419021,125730,544751,21,11,32
228,16,9/27/43,10/29/43,980504,888165,66350,19174.515,1954193.515,1868669,85524.515,Bethlehem,419407,125915,545322,22,10,32
229,7,9/29/43,10/30/43,985140,888165,66515,19222.1835,1959042.184,1873305,85737.1835,Bethlehem,420937,126655,547592,22,9,31
230,9,10/1/43,10/27/43,987219,888165,66589,19243.5621,1961216.562,1875384,85832.5621,Bethlehem,421526,127049,548575,22,4,26
231,13,10/3/43,11/5/43,985012,888165,66510,19220.739,1958907.739,1873177,85730.739,Bethlehem,420654,126789,547443,22,11,33
232,3,10/4/43,11/5/43,945076,855740,63941,18478.5549,1883235.555,1800816,82419.5549,Bethlehem,402216,121599,523815,25,7,32
233,5,10/6/43,11/8/43,981215,888165,66375,19181.7375,1954936.738,1869380,85556.7375,Bethlehem,418814,126569,545383,25,8,33
234,15,10/8/43,11/9/43,978576,888165,66282,19154.8698,1952177.87,1866741,85436.8698,Bethlehem,417811,126237,544048,24,8,32
235,10,10/9/43,11/12/43,959956,888165,65620,18963.618,1932704.618,1848121,84583.618,Bethlehem,410710,123896,534606,27,7,34
236,1,10/10/43,11/15/43,951695,888165,65372,18891.9708,1924123.971,1839860,84263.9708,Bethlehem,407558,122857,530415,27,9,36
237,12,10/11/43,11/15/43,947467,888165,65177,18835.6353,1919644.635,1835632,84012.6353,Bethlehem,405919,122318,528237,28,7,35
238,8,10/12/43,11/17/43,941741,888165,64974,18776.9886,1913656.989,1829906,83750.9886,Bethlehem,403692,121580,525272,28,8,36
239,4,10/15/43,11/20/43,934133,888165,64704,18698.9856,1905700.986,1822298,83402.9856,Bethlehem,400748,120604,521352,29,7,36
240,14,10/16/43,11/19/43,934046,888165,64701,18698.1189,1905610.119,1822211,83399.1189,Bethlehem,400685,120588,521273,27,7,34
241,6,10/17/43,11/22/43,927456,888165,64466,18630.2274,1898717.227,1815621,83096.2274,Bethlehem,398138,119754,517892,28,8,36
242,11,10/17/43,11/23/43,928371,888165,64499,18639.7611,1899674.761,1816536,83138.7611,Bethlehem,398458,119865,518323,29,8,37
243,2,10/18/43,11/26/43,927066,888165,64453,18626.4717,1898310.472,1815231,83079.4717,Bethlehem,397788,119634,517422,31,8,39
244,16,10/19/43,11/25/43,924254,888165,64353,18597.5817,1895369.582,1812419,82950.5817,Bethlehem,396668,119264,515932,28,9,37
245,7,10/21/43,11/29/43,921528,888165,64256,18569.5584,1892518.558,1809693,82825.5584,Bethlehem,395602,118914,514516,29,10,39
246,9,10/23/43,11/29/43,920565,888165,64222,18559.7358,1891511.736,1808730,82781.7358,Bethlehem,395205,118787,513992,28,9,37
247,13,10/25/43,11/30/43,918592,888165,64152,18539.5128,1889448.513,1806757,82691.5128,Bethlehem,394425,118532,512957,27,9,36
248,3,10/29/43,11/29/43,802624,855740,58883,17017.2987,1734264.299,1658364,75900.2987,Bethlehem,341795,102664,444459,25,6,31
249,5,10/31/43,12/3/43,917028,888165,64096,18523.3344,1887812.334,1805193,82619.3344,Bethlehem,391592,117736,509328,25,8,33
250,15,11/1/43,11/30/43,900404,888165,63056,18222.8784,1869847.878,1788569,81278.8784,Bethlehem,387376,116200,503576,23,6,29
251,10,11/5/43,12/6/43,908173,888165,63782,18432.6198,1878552.62,1796338,82214.6198,Bethlehem,386100,116035,502135,21,10,31
252,1,11/6/43,12/7/43,912366,888165,63931,18475.6659,1882937.666,1800531,82406.6659,Bethlehem,385678,116000,501678,23,8,31
253,12,11/8/43,12/8/43,877813,855740,61533,17782.8837,1812868.884,1733553,79315.8837,Bethlehem,367899,110729,478628,22,8,30
254,8,11/9/43,12/8/43,918360,888165,64144,18537.2016,1889206.202,1806525,82681.2016,Bethlehem,384297,115685,499982,21,8,29
255,14,11/12/43,12/13/43,929787,888165,64549,18654.2061,1901155.206,1817952,83203.2061,Bethlehem,383403,115637,499040,21,10,31
256,4,11/13/43,12/13/43,938553,888165,64861,18744.3429,1910323.343,1826718,83605.3429,Bethlehem,382850,115693,498543,21,9,30
257,6,11/14/43,12/14/43,955863,888165,64475,18632.8275,1927135.828,1844028,83107.8275,Bethlehem,382065,115895,497960,22,8,30
258,11,11/15/43,12/17/43,959850,888165,65617,18962.7513,1932594.751,1848015,84579.7513,Bethlehem,381737,115917,497654,22,10,32
259,16,11/16/43,12/15/43,949491,888165,65249,18856.4361,1921761.436,1837656,84105.4361,Bethlehem,381883,116046,497929,19,10,29
260,2,11/18/43,12/18/43,968865,888165,65937,19055.1993,1942022.199,1857030,84992.1993,Bethlehem,381235,116034,497269,21,9,30
261,7,11/19/43,12/20/43,970116,888165,65981,19067.9109,1943329.911,1858281,85048.9109,Bethlehem,381069,116001,497070,23,8,31
262,9,11/20/43,12/20/43,978338,888165,66273,19152.2697,1951928.27,1866503,85425.2697,Bethlehem,380627,116086,496713,20,10,30
263,13,11/21/43,12/23/43,986208,888165,66553,19233.1617,1960159.162,1874373,85786.1617,Bethlehem,380314,116192,496506,23,9,32
264,15,11/24/43,12/24/43,995150,888165,66870,19324.743,1969509.743,1883315,86194.743,Bethlehem,379861,116300,496161,23,7,30
265,5,11/25/43,12/24/43,998225,888165,66979,19356.2331,1972725.233,1886390,86335.2331,Bethlehem,379735,116339,496074,21,8,29
266,10,11/26/43,12/29/43,999416,888165,67022,19368.6558,1973971.656,1887581,86390.6558,Bethlehem,379495,116344,495839,22,11,33
267,1,11/29/43,12/30/43,1002548,888165,67133,19400.7237,1977246.724,1890713,86533.7237,Bethlehem,379442,116410,495852,21,10,31
268,8,11/30/43,12/31/43,1004426,888165,67200,19420.08,1979211.08,1892591,86620.08,Bethlehem,379432,116466,495898,21,10,31
269,12,11/30/43,12/30/43,1004446,888165,67200,19420.08,1979231.08,1892611,86620.08,Bethlehem,379430,116473,495903,21,9,30
270,14,12/3/43,12/31/43,1006191,888165,67262,19437.9918,1981055.992,1894356,86699.9918,Bethlehem,379428,116520,495948,20,8,28
271,4,12/4/43,1/10/44,860140,888165,62076,17939.7564,1828320.756,1748305,80015.7564,Bethlehem,379278,118244,497522,20,17,37
272,16,12/5/43,1/8/44,822586,855740,59592,17222.1288,1755140.129,1678326,76814.1288,Bethlehem,361551,112577,474128,24,10,34
273,6,12/6/43,1/12/44,857160,888165,61971,17909.4219,1825205.422,1745325,79880.4219,Bethlehem,377110,118090,495200,25,12,37
274,11,12/7/43,1/14/44,857486,888165,61982,17912.5998,1825545.6,1745651,79894.5998,Bethlehem,376942,118151,495093,24,14,38
275,2,12/9/43,1/19/44,856342,888165,61942,17901.0438,1824350.044,1744507,79843.0438,Bethlehem,375606,119353,494959,30,11,41
276,9,12/10/43,1/17/44,856536,888165,61948,17902.7772,1824551.777,1744701,79850.7772,Bethlehem,375607,119229,494836,28,10,38
277,7,12/13/43,1/20/44,855750,888165,61921,17894.9769,1823730.977,1743915,79815.9769,Bethlehem,374842,119773,494615,28,10,38
278,13,12/15/43,1/24/44,854525,888165,61877,17882.2653,1822449.265,1742690,79759.2653,Bethlehem,373726,120618,494344,31,9,40
279,5,12/17/43,1/26/44,853271,888165,61833,17869.5537,1821138.554,1741436,79702.5537,Bethlehem,372589,121483,494072,31,9,40
280,15,12/18/43,1/28/44,853382,888165,61836,17870.4204,1821253.42,1741547,79706.4204,Bethlehem,372606,121408,494014,32,9,41
281,10,12/19/43,1/29/44,853200,888165,61830,17868.687,1821063.687,1741365,79698.687,Bethlehem,372390,121536,493926,32,9,41
282,1,12/21/43,1/31/44,852687,888165,61812,17863.4868,1820527.487,1740852,79675.4868,Bethlehem,371909,121891,493800,31,10,41
283,12,12/22/43,2/5/44,853327,888165,61835,17870.1315,1821197.132,1741492,79705.1315,Bethlehem,371263,122237,493500,31,14,45
284,8,12/22/43,2/7/44,853065,888165,61825,17867.2425,1820922.243,1741230,79692.2425,Bethlehem,370818,122443,493261,33,14,47
285,14,12/24/43,2/10/44,853008,888165,61823,17866.6647,1820862.665,1741173,79689.6647,Bethlehem,370595,122496,493091,34,14,48
286,4,12/27/43,2/4/44,853586,888165,61844,17872.7316,1821467.732,1741751,79716.7316,Bethlehem,371101,122405,493506,28,11,39
287,16,12/30/43,2/19/44,852999,888165,61823,17866.6647,1820853.665,1741164,79689.6647,Bethlehem,369975,122892,492867,34,17,51
288,6,1/1/44,2/14/44,852393,888165,61801,17860.3089,1820219.309,1740558,79661.3089,Bethlehem,369499,123299,492798,30,14,44
289,11,1/1/44,2/15/44,852378,888165,61801,17860.3089,1820204.309,1740543,79661.3089,Bethlehem,369369,123316,492685,32,13,45
290,9,1/8/44,2/21/44,852126,888165,61792,17857.7088,1819940.709,1740291,79649.7088,Bethlehem,368671,123551,492222,30,14,44
291,2,1/10/44,2/16/44,852210,888165,61795,17858.5755,1820028.576,1740375,79653.5755,Bethlehem,368777,123481,492258,26,11,37
292,7,1/10/44,2/22/44,852115,888165,61791,17857.4199,1819928.42,1740280,79648.4199,Bethlehem,368454,123573,492027,29,14,43
293,13,1/17/44,2/22/44,851730,888165,61778,17853.6642,1819526.664,1739895,79631.6642,Bethlehem,367434,123927,491361,25,11,36
294,5,1/17/44,2/26/44,851637,888165,61775,17852.7975,1819429.798,1739802,79627.7975,Bethlehem,367112,124020,491132,28,12,40
295,15,1/19/44,3/1/44,851607,888165,61773,17852.2197,1819397.22,1739772,79625.2197,Bethlehem,366950,124052,491002,31,11,42
296,10,1/20/44,2/25/44,744865,855740,56832,16424.7648,1673861.765,1600605,73256.7648,Bethlehem,318055,107347,425402,29,7,36
297,1,1/21/44,3/8/44,851922,888165,61785,17855.6865,1819727.687,1740087,79640.6865,Bethlehem,366861,124545,491406,34,13,47
298,12,1/22/44,3/4/44,851824,888165,61781,17854.5309,1819624.531,1739989,79635.5309,Bethlehem,366667,124486,491153,33,9,42
299,8,1/24/44,3/8/44,851963,888165,61786,17855.9754,1819769.975,1740128,79641.9754,Bethlehem,366616,124700,491316,31,13,44
300,4,1/25/44,2/29/44,851489,888165,61769,17851.0641,1819274.064,1739654,79620.0641,Bethlehem,366292,124181,490473,27,8,35
301,14,1/27/44,3/10/44,852079,888165,61790,17857.131,1819891.131,1740244,79647.131,Bethlehem,366618,124916,491534,30,13,43
302,6,1/31/44,3/13/44,852244,888165,61796,17858.8644,1820063.864,1740409,79654.8644,Bethlehem,366631,125214,491845,29,13,42
303,11,2/2/44,3/14/44,852209,888165,61795,17858.5755,1820027.576,1740374,79653.5755,Bethlehem,366193,125655,491848,30,11,41
304,16,2/2/44,3/17/44,852497,888165,61805,17861.4645,1820328.465,1740662,79666.4645,Bethlehem,366055,125846,491901,34,10,44
305,2,2/5/44,3/16/44,852500,888165,61805,17861.4645,1820331.465,1740665,79666.4645,Bethlehem,366065,125907,491972,28,12,40
306,9,2/7/44,3/22/44,853225,888165,61831,17868.9759,1821089.976,1741390,79699.9759,Bethlehem,366751,126482,493233,32,12,44
307,7,2/8/44,3/21/44,853336,888165,61835,17870.1315,1821206.132,1741501,79705.1315,Bethlehem,366864,126658,493522,30,12,42
308,13,2/11/44,3/27/44,853541,888165,61842,17872.1538,1821420.154,1741706,79714.1538,Bethlehem,367027,126858,493885,32,13,45
309,5,2/15/44,3/25/44,854182,888165,61865,17878.7985,1822090.799,1742347,79743.7985,Bethlehem,367265,127276,494541,30,9,39
310,10,2/18/44,3/29/44,854327,888165,61870,17880.243,1822242.243,1742492,79750.243,Bethlehem,367299,127413,494712,29,11,40
311,15,2/19/44,3/31/44,854499,888165,61876,17881.9764,1822421.976,1742664,79757.9764,Bethlehem,367462,127549,495011,32,9,41
312,12,2/24/44,4/6/44,856843,888165,61959,17905.9551,1824872.955,1745008,79864.9551,Bethlehem,367094,128171,495265,32,10,42
313,1,2/24/44,4/4/44,855354,888165,61907,17890.9323,1823316.932,1743519,79797.9323,Bethlehem,367509,127875,495384,27,13,40
314,8,2/25/44,4/5/44,856122,888165,61933,17898.4437,1824118.444,1744287,79831.4437,Bethlehem,367254,128111,495365,29,11,40
315,14,2/26/44,4/10/44,858374,888165,62014,17921.8446,1826474.845,1746539,79935.8446,Bethlehem,366653,128533,495186,32,12,44
316,6,2/29/44,4/14/44,860898,888165,62103,17947.5567,1829113.557,1749063,80050.5567,Bethlehem,366026,129048,495074,31,14,45
317,11,3/3/44,4/18/44,863580,888165,62199,17975.2911,1831919.291,1751745,80174.2911,Bethlehem,366110,129987,496097,33,13,46
318,2,3/6/44,4/15/44,862633,888165,62165,17965.4685,1830928.469,1750798,80130.4685,Bethlehem,366440,129829,496269,28,12,40
319,16,3/7/44,4/22/44,866703,888165,62309,18007.0701,1835184.07,1754868,80316.0701,Bethlehem,365125,130523,495648,32,14,46
320,7,3/9/44,4/23/44,868049,888165,62357,18020.9373,1836591.937,1756214,80377.9373,Bethlehem,364657,130747,495404,32,13,45
321,9,3/10/44,4/21/44,867644,888165,62343,18016.8927,1836168.893,1755809,80359.8927,Bethlehem,364793,130702,495495,31,11,42
322,13,3/14/44,4/26/44,872111,888165,62501,18062.5389,1840839.539,1760276,80563.5389,Bethlehem,363240,131446,494686,31,12,43
323,5,3/16/44,4/28/44,874200,888165,62576,18084.2064,1843025.206,1762365,80660.2064,Bethlehem,362532,131856,494388,32,11,43
324,10,3/21/44,5/9/44,870839,888165,62456,18049.5384,1839509.538,1759004,80505.5384,Bethlehem,360201,130650,490851,36,13,49
325,15,3/22/44,4/30/44,876417,888165,62654,18106.7406,1845342.741,1764582,80760.7406,Bethlehem,361707,132217,493924,31,8,39
326,1,3/22/44,4/29/44,876369,888165,62653,18106.4517,1845293.452,1764534,80759.4517,Bethlehem,361667,132199,493866,29,9,38
327,8,3/25/44,5/6/44,873370,888165,62546,18075.5394,1842156.539,1761535,80621.5394,Bethlehem,359682,131221,490903,31,11,42
328,12,3/27/44,4/30/44,878456,888165,62727,18127.8303,1847475.83,1766621,80854.8303,Bethlehem,360935,132649,493584,26,8,34
329,14,3/30/44,5/19/44,874377,888165,62582,18085.9398,1843209.94,1762542,80667.9398,Bethlehem,358508,131153,489661,30,20,50
330,6,3/31/44,5/29/44,920907,888165,64234,18563.2026,1891869.203,1809072,82797.2026,Bethlehem,381451,139410,520861,32,27,59
331,2,4/3/44,5/15/44,874894,888165,62600,18091.14,1843750.14,1763059,80691.14,Bethlehem,355079,130534,485613,32,10,42
332,11,4/5/44,5/19/44,972333,888165,62509,18064.8501,1941071.85,1860498,80573.8501,Bethlehem,354126,129804,483930,33,11,44
333,16,4/8/44,5/23/44,869660,888165,62414,18037.4046,1838276.405,1757825,80451.4046,Bethlehem,352420,128797,481217,32,13,45
334,9,4/10/44,5/23/44,868942,888165,62389,18030.1821,1837526.182,1757107,80419.1821,Bethlehem,351967,128548,480515,32,11,43
335,7,4/10/44,5/20/44,763786,855740,57504,16618.9056,1693648.906,1619526,74122.9056,Bethlehem,306165,112356,418521,31,9,40
336,13,4/14/44,5/31/44,862906,888165,62175,17968.3575,1831214.358,1751071,80143.3575,Bethlehem,349623,126723,476346,33,14,47
337,5,4/17/44,5/31/44,864113,888165,62218,17980.7802,1832476.78,1752278,80198.7802,Bethlehem,349889,127063,476952,32,12,44
338,1,4/20/44,5/31/44,754746,855740,57183,16526.1687,1684195.169,1610486,73709.1687,Bethlehem,302666,109633,412299,32,9,41
339,12,4/22/44,6/3/44,859267,888165,62045,17930.8005,1827407.801,1747432,79975.8005,Bethlehem,347998,125630,473628,30,12,42
340,15,4/24/44,6/12/44,858581,888165,62021,17923.8669,1826690.867,1746746,79944.8669,Bethlehem,348252,125740,473992,33,16,49
341,8,4/25/44,6/4/44,858269,888165,62010,17920.689,1826364.689,1746434,79930.689,Bethlehem,347925,125643,473568,29,11,40
342,10,4/26/44,6/15/44,857482,888165,61982,17912.5998,1825541.6,1745647,79894.5998,Bethlehem,348556,125779,474335,40,10,50
343,14,4/29/44,6/19/44,855825,888165,61923,17895.5547,1823808.555,1743990,79818.5547,Bethlehem,348015,125314,473329,39,12,51
344,6,5/2/44,6/9/44,854946,888165,61892,17886.5988,1822889.599,1743111,79778.5988,Bethlehem,347056,124748,471804,28,10,38
345,2,5/5/44,6/13/44,854045,888165,61860,17877.354,1821947.354,1742210,79737.354,Bethlehem,347357,124802,472159,29,10,39
346,11,5/8/44,6/24/44,853975,888165,61858,17876.7762,1821874.776,1742140,79734.7762,Bethlehem,347881,125141,473022,33,14,47
347,16,5/10/44,6/26/44,850771,888165,61744,17843.8416,1818523.842,1738936,79587.8416,Bethlehem,347153,124408,471561,35,12,47
348,7,5/11/44,6/22/44,850684,888165,61741,17842.9749,1818432.975,1738849,79583.9749,Bethlehem,347022,124224,471246,30,12,42
349,9,5/12/44,6/29/44,850750,888165,61743,17843.5527,1818501.553,1738915,79586.5527,Bethlehem,347548,124611,472159,35,13,48
350,13,5/17/44,6/28/44,743936,855740,56799,16415.2311,1672890.231,1599676,73214.2311,Bethlehem,301044,107812,408856,34,8,42
351,5,5/19/44,6/30/44,849896,888165,61713,17834.8857,1817608.886,1738061,79547.8857,Bethlehem,347888,124704,472592,31,11,42
352,12,5/22/44,7/8/44,855202,888165,61901,17889.1989,1823157.199,1743367,79790.1989,Bethlehem,350356,125751,476107,36,11,47
353,1,5/22/44,7/7/44,855417,888165,61909,17891.5101,1823382.51,1743582,79800.5101,Bethlehem,350563,125871,476434,35,11,46
354,8,5/23/44,7/12/44,860733,888165,62097,17945.8233,1828940.823,1748898,80042.8233,Bethlehem,352293,126494,478787,37,13,50
355,15,5/27/44,7/11/44,860143,888165,62077,17940.0453,1828325.045,1748308,80017.0453,Bethlehem,352420,126592,479012,33,12,45
356,6,5/30/44,7/15/44,863484,888165,62195,17974.1355,1831818.136,1751649,80169.1355,Bethlehem,353720,127123,480843,32,14,46
357,2,6/3/44,7/22/44,875763,888165,62631,18100.0959,1844659.096,1763928,80731.0959,Bethlehem,357813,128786,486599,37,12,49
358,10,6/5/44,7/24/44,875442,888165,62620,18096.918,1844323.918,1763607,80716.918,Bethlehem,357730,128761,486491,36,13,49
359,14,6/7/44,7/20/44,757349,855740,57275,16552.7475,1686916.748,1613089,73827.7475,Bethlehem,306961,110378,417339,31,12,43
360,7,6/10/44,7/28/44,884768,888165,62951,18192.5439,1854076.544,1772933,81143.5439,Bethlehem,360597,129916,490513,38,10,48
361,16,6/15/44,7/29/44,889341,888165,63113,18239.3457,1858858.346,1777506,81352.3457,Bethlehem,362057,130462,492519,34,10,44
362,9,6/16/44,7/31/44,897769,888165,63413,18326.0157,1867673.016,1785934,81739.0157,Bethlehem,364995,131653,496648,36,9,45
363,13,6/20/44,8/10/44,900458,888165,63508,18353.4612,1870484.461,1788623,81861.4612,Bethlehem,366194,131919,498113,37,14,51
364,1,6/26/44,8/11/44,907121,888165,63745,18421.9305,1877452.931,1795286,82166.9305,Bethlehem,368261,132617,500878,32,14,46
365,12,6/27/44,8/16/44,791649,855740,58493,16904.6277,1722786.628,1647389,75397.6277,Bethlehem,318521,114846,433367,34,16,50
366,8,6/30/44,8/23/44,907719,888165,63766,18427.9974,1878077.997,1795884,82193.9974,Bethlehem,367788,131851,499639,38,16,54
367,6,7/1/44,8/26/44,796950,855740,58681,16958.9409,1728329.941,1652690,75639.9409,Bethlehem,319812,114946,434758,35,21,56
368,14,7/8/44,8/26/44,910605,888165,63868,18457.4652,1881095.465,1798770,82325.4652,Bethlehem,368401,131766,500167,33,16,49
369,2,7/10/44,8/29/44,796255,855740,58657,16952.0073,1727604.007,1651995,75609.0073,Bethlehem,319016,114093,433109,33,17,50
370,7,7/19/44,8/31/44,909446,888165,63827,18445.6203,1879883.62,1797611,82272.6203,Bethlehem,367232,130724,497956,34,9,43
371,16,7/19/44,8/30/44,910799,888165,63875,18459.4875,1881298.488,1798964,82334.4875,Bethlehem,367728,130937,498665,33,9,42
372,9,7/22/44,9/11/44,911660,888165,63906,18468.4434,1882199.443,1799825,82374.4434,Bethlehem,367258,130497,497755,35,16,51
373,1,7/28/44,9/13/44,911779,888165,93910,27136.599,1920990.599,1799944,121046.599,Bethlehem,366837,130141,496978,33,14,47
374,12,7/31/44,9/27/44,915236,888165,94033,27172.1337,1924606.134,1803401,121205.1337,Bethlehem,366852,129965,496817,35,23,58
375,8,8/7/44,9/28/44,800461,855740,58806,16995.0534,1732002.053,1656201,75801.0534,Bethlehem,317522,112535,430057,37,15,52
376,14,8/10/44,9/29/44,917402,888165,64110,18527.379,1888204.379,1805567,82637.379,Bethlehem,366893,129916,496809,33,17,50
377,2,8/12/44,9/30/44,919948,888165,64200,18553.38,1890866.38,1808113,82753.38,Bethlehem,366744,129766,496510,35,14,49
378,16,8/21/44,10/7/44,931125,888165,64597,18668.0733,1902555.073,1819290,83265.0733,Bethlehem,369374,130980,500354,31,16,47
379,7,8/22/44,10/11/44,940698,888165,64937,18766.2993,1912566.299,1828863,83703.2993,Bethlehem,371975,132208,504183,31,19,50
380,9,8/26/44,10/14/44,945504,888165,65107,18815.4123,1917591.412,1833669,83922.4123,Bethlehem,372963,132683,505646,32,17,49
381,1,8/30/44,10/21/44,816105,855740,59362,17155.6818,1748362.682,1671845,76517.6818,Bethlehem,319824,113271,433095,36,16,52
382,12,9/4/44,10/25/44,832513,855740,59944,17323.8216,1765520.822,1688253,77267.8216,Bethlehem,324674,115686,440360,36,15,51
383,2,9/16/44,10/30/44,874810,855740,61446,17757.7494,1809753.749,1730550,79203.7494,Bethlehem,337499,122181,459680,32,12,44
384,16,9/21/44,10/31/44,855740,855740,61974,17910.2886,1791364.289,1711480,79884.2886,Bethlehem,341448,124193,465641,28,12,40
1,1,5/24/41,2/21/42,2761167,888165,129575,37445,3816352,3649332,167020,California,1260947,474058,1735005,126,147,273
2,2,5/24/41,3/7/42,2496684,888165,120185,34732,3539766,3384849,154917,California,1131805,425504,1557309,155,132,287
3,3,6/21/41,3/21/42,2567434,888165,122697,35458,3613754,3455599,158155,California,1166351,438492,1604843,148,125,273
4,4,6/27/41,3/30/42,2384151,888165,116189,33577,3422082,3272316,149766,California,1076857,404846,1481703,159,117,276
5,5,7/10/41,4/8/42,2347975,888165,114904,33206,3384250,3236140,148110,California,1059193,398205,1457398,164,108,272
6,6,7/17/41,4/15/42,2290809,888165,112875,32619,3324468,3178974,145494,California,1031280,387711,1418991,181,91,272
7,7,7/23/41,4/24/42,2218177,888165,110296,31874,3248512,3106342,142170,California,995815,374377,1370192,189,86,275
8,8,7/31/41,4/28/42,2093410,888165,105866,30594,3118035,2981575,136460,California,934894,351473,1286367,184,87,271
9,9,9/11/41,4/30/42,1929247,888165,100037,28909,2946358,2817412,128946,California,854799,321360,1176159,154,77,231
10,10,9/15/41,5/9/42,1746067,888165,93533,27030,2754795,2634232,120563,California,542908,204101,747009,156,80,236
11,11,9/22/41,5/20/42,1748013,888165,93602,27050,2756830,2636178,120652,California,543858,204458,748316,159,81,240
12,1,9/29/41,5/7/42,1929597,888165,100049,28913,2946724,2817762,128962,California,854907,321401,1176308,128,92,220
13,12,10/6/41,5/29/42,1684709,888165,91354,26400,2690628,2572874,117754,California,512948,192837,705785,156,79,235
14,13,10/13/41,5/16/42,1739985,888165,93317,26967,2748434,2628150,120284,California,762386,286617,1049003,160,55,215
15,14,10/20/41,5/20/42,1778000,888165,94667,27357,2788189,2666165,122024,California,780948,293595,1074543,162,50,212
16,2,10/27/41,5/9/42,1837617,888165,96783,27969,2850534,2725782,124752,California,809995,304516,1114511,120,74,194
17,3,11/17/41,5/13/42,1679122,888165,91156,26343,2684786,2567287,117499,California,732605,275420,1008025,109,68,177
18,4,12/3/41,6/10/42,1679828,888165,91181,26350,2685524,2567993,117531,California,510502,191918,702420,120,69,189
19,5,12/22/41,5/23/42,1653555,888165,90248,26080,2658048,2541720,116328,California,720121,270726,990847,107,45,152
20,6,1/14/42,6/20/42,1641279,888165,89812,25954,2645210,2529444,115766,California,491679,184841,676520,90,67,157
21,7,1/28/42,5/27/42,1589168,888165,87962,25420,2590715,2477333,113382,California,688682,258906,947588,78,41,119
22,8,1/31/42,5/29/42,1588189,888165,87927,25410,2589691,2476354,113337,California,688204,258727,946931,80,38,118
23,1,2/4/42,6/3/42,1584738,888165,87804,25374,2586081,2472903,113178,California,686519,258093,944612,82,37,119
24,9,2/12/42,6/6/42,1618165,888165,88991,25717,2621038,2506330,114708,California,702904,264254,967158,77,37,114
25,10,2/18/42,6/9/42,1569005,888165,87246,25213,2569629,2457170,112459,California,678900,255229,934129,76,35,111
26,2,2/24/42,6/13/42,1485944,888165,84297,24360,2482766,2374109,108657,California,638280,239958,878238,78,31,109
27,11,2/28/42,6/11/42,1502056,888165,84869,24526,2499616,2390221,109395,California,646210,242939,889149,70,33,103
28,3,3/6/42,6/16/42,1430186,888165,82317,23788,2424456,2318351,106105,California,611117,229745,840862,71,31,102
29,12,3/11/42,6/18/42,1502185,888165,84873,24527,2499750,2390350,109400,California,646210,242939,889149,69,30,99
30,13,3/22/42,6/20/42,1459828,888165,83369,24093,2455455,2347993,107462,California,625591,235187,860778,62,28,90
31,14,3/31/42,6/22/42,1442138,888165,82741,23911,2436955,2330303,106652,California,616953,231939,848892,57,26,83
32,4,4/2/42,6/24/42,1433305,888165,82428,23820,2427718,2321470,106248,California,612577,230294,842871,62,21,83
33,5,4/8/42,6/26/42,1383802,888165,80670,23312,2375949,2271967,103982,California,588406,221207,809613,60,19,79
34,6,4/14/42,6/28/42,1381382,888165,80584,23288,2373419,2269547,103872,California,587224,220762,807986,56,19,75
35,7,4/16/42,6/30/42,1379276,888165,80509,23266,2371216,2267441,103775,California,586196,220376,806572,57,18,75
36,8,4/21/42,7/6/42,1419626,888165,81942,23680,2413413,2307791,105622,California,594095,223346,817441,54,22,76
37,1,4/27/42,7/10/42,1351740,888165,79532,22983,2342420,2239905,102515,California,560948,210884,771832,53,21,74
38,9,4/30/42,7/14/42,1375453,888165,80373,23227,2367218,2263618,103600,California,580317,218166,798483,52,23,75
39,10,5/5/42,7/16/42,1351776,888165,79533,22984,2342458,2239941,102517,California,568756,213819,782575,49,23,72
40,11,5/9/42,7/19/42,1344528,888165,79275,22909,2334877,2232693,102184,California,565217,212489,777706,49,22,71
41,2,5/13/42,7/21/42,1312040,888165,78122,22576,2300903,2200205,100698,California,541563,203596,745159,47,22,69
42,3,5/16/42,7/25/42,1352054,888165,79543,22987,2342749,2240219,102530,California,561101,210941,772042,48,22,70
43,12,5/20/42,7/23/42,1250404,888165,75933,21944,2236446,2138569,97877,California,519258,195210,714468,41,23,64
44,13,5/23/42,7/27/42,1287258,888165,77242,22322,2274987,2175423,99564,California,537253,201975,739228,48,17,65
45,14,5/27/42,7/31/42,1271800,888165,76693,22163,2258821,2159965,98856,California,529705,199138,728843,46,19,65
46,4,6/3/42,8/4/42,1279462,888165,76963,22242,2266832,2167627,99205,California,522502,196429,718931,32,30,62
47,5,6/7/42,8/6/42,1254239,888165,76070,21983,2240457,2142404,98053,California,508457,191149,699606,42,18,60
48,6,6/9/42,8/10/42,1241427,888165,75616,21852,2227060,2129592,97468,California,502223,188806,691029,42,20,62
49,7,6/12/42,8/13/42,1225079,888165,75034,21684,2209962,2113244,96718,California,494219,185796,680015,42,20,62
50,8,6/14/42,8/15/42,1234010,888165,75351,21775,2219301,2122175,97126,California,511253,192200,703453,42,20,62
51,1,6/19/42,8/18/42,1210864,888165,74329,21538,2194896,2099029,95867,California,499951,187832,687783,40,20,60
52,9,6/21/42,8/20/42,1232482,888165,75297,21760,2217704,2120647,97057,California,510507,191801,702308,40,20,60
53,10,6/23/42,8/25/42,1233314,888165,75327,21768,2218574,2121479,97095,California,509008,191237,700245,42,21,63
54,11,6/27/42,8/27/42,1198009,888165,74073,21406,2181653,2086174,95479,California,488792,183635,672427,42,19,61
55,2,6/29/42,8/29/42,1196092,888165,74005,21386,2179648,2084257,95391,California,489257,181995,671252,42,19,61
56,12,6/30/42,8/30/42,1320473,888165,78421,22663,2309722,2208638,101084,California,491227,164673,655900,44,17,61
57,3,7/3/42,9/3/42,1317646,888165,78321,22634,2306766,2205811,100955,California,515353,172764,688117,43,19,62
58,13,7/10/42,9/5/42,1254162,888165,76067,21982,2240376,2142327,98049,California,466253,156298,622551,38,19,57
59,14,7/12/42,9/8/42,1229278,888165,75183,21727,2214353,2117443,96910,California,464066,155565,619631,38,20,58
60,4,7/15/42,9/10/42,1203053,888165,74252,21458,2186928,2091218,95710,California,467761,156804,624565,38,19,57
61,5,7/19/42,9/12/42,1153229,888165,72483,20946,2134823,2041394,93429,California,457397,153328,610725,37,18,55
62,6,7/21/42,9/15/42,1141057,888165,72051,20822,2122095,2029222,92873,California,454457,152342,606799,37,19,56
63,7,7/24/42,9/17/42,1112079,888165,71022,20524,2091790,2000244,91546,California,464971,155868,620839,38,17,55
64,8,7/26/42,9/19/42,1086785,888165,70124,20265,2065339,1974950,90389,California,459092,153896,612988,40,15,55
65,1,7/29/42,9/22/42,1063855,888165,69310,20029,2041359,1952020,89339,California,466607,156417,623024,40,15,55
66,9,7/31/42,9/24/42,1024027,888165,67896,19620,1999708,1912192,87516,California,452681,151746,604427,40,15,55
67,10,8/4/42,9/26/42,1019129,888165,67722,19570,1994586,1907294,87292,California,440096,147526,587622,38,15,53
68,11,8/9/42,9/30/42,1017611,888165,67668,19555,1992999,1905776,87223,California,438236,146902,585138,36,16,52
69,2,8/10/42,10/6/42,1017289,888165,67656,19552,1992662,1905454,87208,California,469290,157316,626606,39,18,57
70,12,8/13/42,10/8/42,1020858,888165,67783,19588,1996394,1909023,87371,California,454376,152315,606691,39,17,56
71,3,8/15/42,10/10/42,1031009,888165,68143,19692,2007009,1919174,87835,California,456427,153003,609430,39,17,56
72,13,8/17/42,10/13/42,1038946,888165,68425,19774,2015310,1927111,88199,California,428864,143759,572623,39,18,57
73,14,8/19/42,10/17/42,1054972,888165,68994,19938,2032069,1943137,88932,California,433798,145414,579212,41,18,59
74,4,8/22/42,10/15/42,1049281,888165,68792,19880,2026118,1937446,88672,California,420955,141107,562062,36,18,54
75,5,8/25/42,10/22/42,1077887,888165,69808,20173,2056033,1966052,89981,California,426587,142996,569583,40,18,58
76,6,8/27/42,10/20/42,1069961,888165,69526,20092,2047744,1958126,89618,California,400296,134179,534475,34,20,54
77,7,8/31/42,10/24/42,1086062,888165,70098,20257,2064582,1974227,90355,California,411032,137780,548812,37,17,54
78,8,9/4/42,10/27/42,1097841,888165,70517,20378,2076901,1986006,90895,California,406689,136323,543012,35,18,53
79,1,9/7/42,10/29/42,1095214,888165,70423,20351,2074153,1983379,90774,California,417787,140045,557832,34,18,52
80,9,9/9/42,11/3/42,1101041,888165,70630,20411,2080247,1989206,91041,California,418716,140356,559072,36,19,55
81,10,9/11/42,10/31/42,1115539,888165,71145,20560,2095409,2003704,91705,California,397171,133131,530302,32,18,50
82,11,9/13/42,11/5/42,1112654,888165,71042,20530,2092391,2000819,91572,California,405547,135940,541487,35,18,53
83,2,9/18/42,11/7/42,1125730,888165,71507,20664,2106066,2013895,92171,California,413228,138516,551744,33,17,50
84,12,9/21/42,11/10/42,1130491,888165,71676,20713,2111045,2018656,92389,California,408827,137040,545867,33,17,50
85,3,9/23/42,11/12/42,1131448,888165,71710,20723,2112046,2019613,92433,California,415431,139255,554686,33,17,50
86,13,9/25/42,11/14/42,1121327,888165,71350,20619,2101461,2009492,91969,California,393531,131910,525441,33,17,50
87,4,9/27/42,11/17/42,1111833,888165,71013,20522,2091533,1999998,91535,California,396635,132951,529586,33,18,51
88,14,9/29/42,11/19/42,1101096,888165,70632,20412,2080305,1989261,91044,California,399365,133867,533232,32,19,51
89,6,9/30/42,11/21/42,1095686,888165,70440,20356,2074647,1983851,90796,California,395144,132451,527595,34,18,52
90,5,10/4/42,11/24/42,1085510,888165,70079,20252,2064006,1973675,90331,California,387302,129822,517124,32,19,51
91,7,10/7/42,11/28/42,1072776,888165,69626,20121,2050688,1960941,89747,California,400498,134247,534745,33,19,52
92,8,10/9/42,11/26/42,1064283,888165,69325,20034,2041807,1952448,89359,California,387072,129744,516816,29,19,48
93,1,10/11/42,12/3/42,1047961,888165,68745,19867,2024738,1936126,88612,California,412986,138435,551421,34,19,53
94,10,10/13/42,11/30/42,1040413,888165,68477,19789,2016844,1928578,88266,California,383618,128586,512204,29,19,48
95,9,10/15/42,12/5/42,1023059,888165,67861,19611,1998696,1911224,87472,California,394654,132687,527341,32,19,51
96,11,10/18/42,12/8/42,1009699,888165,67387,19474,1984725,1897864,86861,California,390603,130928,521531,31,20,51
97,2,10/21/42,12/10/42,1000156,888165,67048,19376,1974745,1888321,86424,California,398495,133575,532070,31,19,50
98,12,10/24/42,12/12/42,994400,888165,66844,19317,1968726,1882565,86161,California,393571,131924,525495,30,19,49
99,3,10/26/42,12/15/42,991950,888165,66757,19291,1966163,1880115,86048,California,404025,135430,539455,30,20,50
100,13,10/28/42,12/17/42,995486,888165,66882,19328,1969861,1883651,86210,California,396569,132929,529498,30,20,50
101,4,10/30/42,12/19/42,1005802,888165,67248,19434,1980649,1893967,86682,California,398929,133721,532650,29,21,50
102,14,10/31/42,12/21/42,980441,888165,66348,19174,1954128,1868606,85522,California,411520,137943,549463,31,20,51
103,6,11/3/42,12/22/42,989072,888165,66655,19262,1963154,1877237,85917,California,400472,134238,534710,31,18,49
104,5,11/5/42,12/27/42,998557,888165,66991,19360,1973073,1886722,86351,California,401071,134439,535510,34,18,52
105,8,11/7/42,12/23/42,1002115,888165,67117,19396,1976793,1890280,86513,California,395486,132566,528052,30,16,46
106,7,11/9/42,12/29/42,1007832,888165,67324,19456,1982777,1895997,86780,California,401797,134682,536479,34,16,50
107,10,11/11/42,12/28/42,1013807,888165,67533,19516,1989021,1901972,87049,California,386909,129690,516599,31,16,47
108,1,11/14/42,12/31/42,1019744,888165,67743,19577,1995229,1907909,87320,California,409679,137326,547005,35,12,47
109,9,11/16/42,12/31/42,1031411,888165,68158,19696,2007430,1919576,87854,California,386721,129627,516348,31,14,45
110,11,11/18/42,1/6/43,1002576,888165,67134,19402,1977277,1890741,86536,California,380297,127472,507769,34,15,49
111,2,11/21/42,1/8/43,1009151,888165,67367,19468,1984151,1897316,86835,California,380965,127696,508661,32,16,48
112,12,11/23/42,1/8/43,1012417,888165,67483,19502,1987567,1900582,86985,California,375398,125830,501228,34,12,46
113,3,11/25/42,1/10/43,992997,888165,66794,19302,1967258,1881162,86096,California,381013,127712,508725,33,13,46
114,13,11/27/42,1/12/43,817312,888165,60556,17500,1783533,1705477,78056,California,365834,122622,488456,32,14,46
115,4,11/28/42,1/13/43,930193,888165,64564,18658,1901580,1818358,83222,California,363805,121942,485747,32,14,46
116,14,12/1/42,1/16/43,987037,888165,66582,19241,1961025,1875202,85823,California,365989,122674,488663,30,16,46
117,6,12/4/42,1/17/43,937826,888165,64835,18736,1909562,1825991,83571,California,368298,123448,491746,30,14,44
118,8,12/7/42,1/20/43,927465,888165,64467,18630,1898727,1815630,83097,California,363101,121706,484807,29,15,44
119,5,12/9/42,1/22/43,933851,888165,64694,18690,1905400,1822016,83384,California,364086,122036,486122,29,15,44
120,10,12/12/42,1/25/43,975485,888165,66172,19123,1948945,1863650,85295,California,367052,123031,490083,28,16,44
121,7,12/13/42,1/26/43,960669,888165,65646,18971,1933451,1848834,84617,California,375125,125738,500863,29,15,44
122,9,12/17/42,1/28/43,988909,888165,66649,19260,1962983,1877074,85909,California,363570,121863,485433,26,16,42
123,1,12/19/42,1/31/43,958946,888165,65585,18953,1931649,1847111,84538,California,382722,128285,511007,27,16,43
124,11,12/22/42,2/2/43,957801,888165,65544,18941,1930451,1845966,84485,California,378368,126826,505194,27,15,42
125,2,12/23/42,2/6/43,937613,888165,64827,18734,1909339,1825778,83561,California,378051,126719,504770,27,18,45
126,12,12/27/42,2/7/43,939694,888165,64901,18755,1911515,1827859,83656,California,371578,124549,496127,25,17,42
127,3,12/28/42,2/9/43,960469,888165,65639,18969,1933242,1848634,84608,California,374827,125638,500465,27,16,43
128,13,12/29/42,2/11/43,944159,888165,65060,18801,1916185,1832324,83861,California,367751,123265,491016,28,16,44
129,4,12/30/42,2/12/43,954156,888165,65415,18904,1926640,1842321,84319,California,366503,122846,489349,29,15,44
130,14,12/31/42,2/15/43,978066,888165,66264,19149,1951644,1866231,85413,California,377218,126440,503658,30,16,46
131,6,1/3/43,2/17/43,927637,888165,64473,18632,1898907,1815802,83105,California,370380,124147,494527,28,17,45
132,8,1/5/43,2/19/43,930206,888165,64564,18658,1901593,1818371,83222,California,366850,122963,489813,28,17,45
133,5,1/7/43,2/21/43,929761,888165,64548,18654,1901128,1817926,83202,California,364836,122288,487124,28,17,45
134,10,1/9/43,2/23/43,944388,888165,65068,18804,1916425,1832553,83872,California,368126,123391,491517,28,17,45
135,7,1/11/43,2/25/43,952337,888165,65350,18885,1924737,1840502,84235,California,367574,123206,490780,28,17,45
136,9,1/12/43,2/27/43,969422,888165,65957,19061,1942605,1857587,85018,California,373128,125068,498196,28,18,46
137,1,1/15/43,2/28/43,977792,888165,66254,19146,1951357,1865957,85400,California,376449,126182,502631,28,16,44
138,11,1/19/43,3/3/43,974565,888165,66139,19113,1947982,1862730,85252,California,375142,125743,500885,25,18,43
139,2,1/20/43,3/5/43,974460,888165,66136,19112,1947873,1862625,85248,California,370292,124117,494409,27,17,44
140,12,1/21/43,3/7/43,980479,888165,66349,19174,1954167,1868644,85523,California,375015,125701,500716,28,17,45
141,3,1/24/43,3/9/43,979480,888165,66314,19164,1953123,1867645,85478,California,371936,124669,496605,27,17,44
142,13,1/26/43,3/11/43,973920,888165,66116,19107,1947308,1862085,85223,California,366779,122939,489718,28,16,44
143,4,1/28/43,3/13/43,964886,888165,65796,19014,1937861,1853051,84810,California,359105,120366,479471,27,17,44
144,14,1/30/43,3/15/43,975092,888165,66158,19119,1948534,1863257,85277,California,369111,123721,492832,28,16,44
145,6,1/31/43,3/17/43,983538,888165,66458,19205,1957366,1871703,85663,California,365501,122511,488012,28,17,45
146,8,2/2/43,3/19/43,967434,888165,65886,19040,1940525,1855599,84926,California,358861,120284,479145,28,17,45
147,5,2/4/43,3/21/43,976765,888165,66217,19136,1950283,1864930,85353,California,363212,121742,484954,28,17,45
148,10,2/6/43,3/23/43,976059,888165,66192,19129,1949545,1864224,85321,California,365339,122455,487794,28,17,45
149,7,2/8/43,3/24/43,967295,888165,65881,19039,1940380,1855460,84920,California,359028,120339,479367,28,16,44
150,9,2/9/43,3/26/43,966012,888165,65836,19026,1939039,1854177,84862,California,359016,120335,479351,29,16,45
151,1,2/12/43,3/28/43,974032,888165,66120,19108,1947425,1862197,85228,California,363521,121845,485366,28,16,44
152,11,2/15/43,3/30/43,955370,888165,65458,18916,1927909,1843535,84374,California,357277,119752,477029,28,15,43
153,2,2/17/43,3/31/43,964335,888165,65776,19008,1937284,1852500,84784,California,358858,120282,479140,27,15,42
154,12,2/18/43,3/31/43,951180,888165,65307,18873,1923525,1839345,84180,California,353670,118542,472212,27,14,41
155,3,2/20/43,4/4/43,942577,888165,65003,18785,1914530,1830742,83788,California,350951,117626,468577,27,16,43
156,4,2/24/43,4/7/43,930324,888165,64568,18659,1901716,1818489,83227,California,342844,114907,457751,27,15,42
157,13,2/24/43,4/6/43,930809,888165,64586,18664,1902224,1818974,83250,California,344828,115573,460401,26,15,41
158,14,2/27/43,4/9/43,939240,888165,64885,18751,1911041,1827405,83636,California,348993,116970,465963,27,14,41
159,6,2/28/43,4/10/43,925700,888165,64404,18612,1896881,1813865,83016,California,343292,115058,458350,27,14,41
160,8,3/2/43,4/12/43,939928,888165,64909,18758,1911760,1828093,83667,California,348850,116920,465770,27,14,41
161,5,3/4/43,4/14/43,949280,888165,65241,18854,1921540,1837445,84095,California,341152,114339,455491,27,14,41
162,10,3/6/43,4/16/43,962443,888165,65709,18989,1935306,1850608,84698,California,344283,115389,459672,27,14,41
163,7,3/9/43,4/17/43,983777,888165,66466,19208,1957616,1871942,85674,California,347263,116387,463650,27,12,39
164,9,3/10/43,4/19/43,1006652,888165,67279,19443,1981539,1894817,86722,California,342157,113778,455935,26,14,40
165,1,3/12/43,4/21/43,838257,888165,61299,17715,1805436,1726422,79014,California,355098,97366,452464,26,14,40
166,11,3/15/43,4/23/43,830244,888165,61015,17632,1797056,1718409,78647,California,330978,116076,447054,26,13,39
167,2,3/16/43,4/24/43,826326,888165,60876,17592,1792959,1714491,78468,California,326405,114622,441027,27,12,39
168,12,3/17/43,4/26/43,826424,888165,60879,17593,1793061,1714589,78472,California,324481,114109,438590,27,13,40
169,3,3/19/43,4/27/43,829557,888165,60991,17625,1796338,1717722,78616,California,320778,112937,433715,26,13,39
170,13,3/22/43,4/28/43,841946,888165,61430,17753,1809294,1730111,79183,California,325948,114975,440923,25,12,37
171,4,3/24/43,4/29/43,805196,888165,60126,17375,1770862,1693361,77501,California,304986,107722,412708,24,12,36
172,14,3/26/43,4/30/43,811908,888165,60364,17444,1777881,1700073,77808,California,308736,109254,417990,23,12,35
173,6,3/27/43,4/30/43,819931,888165,60649,17527,1786272,1708096,78176,California,312059,110649,422708,25,9,34
174,8,3/29/43,5/4/43,821348,888165,60699,17541,1787753,1709513,78240,California,312202,110928,423130,24,12,36
175,5,3/31/43,5/6/43,831402,888165,61056,17644,1798267,1719567,78700,California,312340,111218,423558,23,13,36
176,10,4/2/43,5/8/43,830289,888165,61017,17633,1797104,1718454,78650,California,316567,112971,429538,24,12,36
177,7,4/5/43,5/10/43,809220,888165,60268,17417,1775070,1697385,77685,California,306396,109576,415972,22,13,35
178,9,4/6/43,5/11/43,815332,888165,60485,17479,1781461,1703497,77964,California,307704,110159,417863,22,13,35
179,1,4/7/43,5/13/43,825473,888165,60846,17583,1792067,1713638,78429,California,308404,110578,418982,23,13,36
180,11,4/10/43,5/15/43,827959,888165,60934,17609,1794667,1716124,78543,California,310540,111582,422122,22,13,35
181,2,4/12/43,5/16/43,802111,888165,60016,17344,1767636,1690276,77360,California,298865,107599,406464,22,12,34
182,12,4/13/43,5/18/43,814597,888165,60459,17472,1780693,1702762,77931,California,302727,109103,411830,22,13,35
183,3,4/14/43,5/19/43,811437,888165,60347,17439,1777388,1699602,77786,California,303620,109559,413179,23,12,35
184,13,4/16/43,5/21/43,830380,888165,61020,17634,1797199,1718545,78654,California,309485,111870,421355,22,13,35
185,4,4/17/43,5/23/43,825698,888165,60854,17586,1792303,1713863,78440,California,306869,111046,417915,23,13,36
186,14,4/18/43,5/24/43,810107,888165,60300,17426,1775998,1698272,77726,California,299485,108532,408017,23,13,36
187,6,4/22/43,5/26/43,820959,888165,60685,17537,1787346,1709124,78222,California,302662,109852,412514,21,13,34
188,8,4/23/43,5/27/43,808944,888165,60259,17414,1774782,1697109,77673,California,300459,109141,409600,21,13,34
189,5,4/24/43,5/29/43,820870,888165,60682,17536,1787253,1709035,78218,California,305575,111109,416684,22,13,35
190,10,4/26/43,5/30/43,824924,888165,60826,17578,1791493,1713089,78404,California,306185,111448,417633,22,12,34
191,7,4/27/43,5/31/43,815022,888165,60474,17476,1781137,1703187,77950,California,299196,108982,408178,23,11,34
192,9,4/28/43,6/4/43,842199,888165,61439,17755,1809558,1730364,79194,California,310867,113299,424166,24,13,37
193,1,4/30/43,6/6/43,843574,888165,61488,17769,1810996,1731739,79257,California,311627,113719,425346,23,14,37
194,11,5/2/43,6/8/43,818801,888165,60609,17515,1785090,1706966,78124,California,302517,110485,413002,23,14,37
195,2,5/4/43,6/9/43,822801,888165,60752,17557,1789275,1710966,78309,California,301314,110140,411454,23,13,36
196,12,5/6/43,6/11/43,827330,888165,60911,17603,1794009,1715495,78514,California,307238,112441,419679,22,14,36
197,3,5/8/43,6/12/43,834696,888165,61173,17678,1801712,1722861,78851,California,311999,114324,426323,22,13,35
198,13,5/9/43,6/14/43,845615,888165,61561,17790,1813131,1733780,79351,California,315606,115765,431371,22,14,36
199,4,5/10/43,6/15/43,825552,888165,60848,17584,1792149,1713717,78432,California,303815,111575,415390,21,15,36
200,14,5/11/43,6/17/43,844839,888165,61533,17782,1812319,1733004,79315,California,312853,114966,427819,22,15,37
201,6,5/13/43,6/18/43,832587,888165,61098,17656,1799506,1720752,78754,California,309589,113898,423487,23,13,36
202,8,5/14/43,6/19/43,813807,888165,60431,17464,1779867,1701972,77895,California,305249,112399,417648,23,13,36
203,5,5/16/43,6/20/43,805812,888165,60147,17382,1771506,1693977,77529,California,301324,111092,412416,23,12,35
204,10,5/18/43,6/22/43,816847,888165,60539,17495,1783046,1705012,78034,California,306919,113302,420221,23,12,35
205,7,5/20/43,6/23/43,796784,888165,59827,17289,1762065,1684949,77116,California,299984,110880,410864,23,11,34
206,9,5/22/43,6/25/43,793509,888165,59711,17255,1758640,1681674,76966,California,298452,110430,408882,23,11,34
207,1,5/24/43,6/26/43,790115,888165,59590,17221,1755091,1678280,76811,California,297962,110358,408320,22,11,33
208,11,5/25/43,6/28/43,785551,888165,59428,17174,1750318,1673716,76602,California,294864,109349,404213,23,11,34
209,2,5/27/43,6/29/43,781695,888165,59291,17134,1746285,1669860,76425,California,294858,109507,404365,22,11,33
210,12,5/28/43,6/30/43,780243,888165,59240,17119,1744767,1668408,76359,California,293390,109112,402502,22,11,33
211,3,5/30/43,6/30/43,789050,888165,59552,17210,1753977,1677215,76762,California,296156,110374,406530,22,9,31
212,13,5/31/43,7/8/43,817149,888165,60550,17498,1783362,1705314,78048,California,316783,118859,435642,24,14,38
213,4,5/31/43,7/9/43,788028,888165,59516,17199,1752908,1676193,76715,California,304653,114760,419413,25,14,39
214,14,6/2/43,7/11/43,801747,888165,60003,17340,1767255,1689912,77343,California,308505,116866,425371,26,13,39
215,6,6/6/43,7/12/43,785926,888165,59441,17178,1750710,1674091,76619,California,299829,114071,413900,23,13,36
216,8,6/7/43,7/14/43,790093,888165,59589,17220,1755067,1678258,76809,California,300747,115023,415770,23,14,37
217,5,6/8/43,7/15/43,789564,888165,59571,17215,1754515,1677729,76786,California,301709,115768,417477,22,15,37
218,10,6/10/43,7/17/43,803412,888165,60062,17357,1768996,1691577,77419,California,308226,118715,426941,23,14,37
219,7,6/12/43,7/20/43,827392,888165,60914,17603,1794074,1715557,78517,California,312010,120706,432716,26,12,38
220,9,6/14/43,7/22/43,827837,888165,60929,17608,1794539,1716002,78537,California,310430,120742,431172,26,12,38
221,1,6/15/43,7/23/43,800734,888165,59967,17330,1766196,1688899,77297,California,295358,115106,410464,26,12,38
222,11,6/17/43,7/25/43,822943,888165,60756,17558,1789422,1711108,78314,California,299529,117484,417013,25,13,38
223,2,6/18/43,7/26/43,827229,888165,60908,17601,1793903,1715394,78509,California,296046,116288,412334,25,13,38
224,12,6/20/43,7/28/43,922872,888165,64304,18583,1893924,1811037,82887,California,303195,119341,422536,25,13,38
225,3,6/21/43,7/30/43,839971,888165,61360,17732,1807228,1728136,79092,California,304558,119550,424108,26,13,39
226,13,6/24/43,7/31/43,824148,888165,60798,17570,1790681,1712313,78368,California,300769,118371,419140,24,13,37
227,4,6/25/43,7/31/43,797886,888165,59866,17300,1763217,1686051,77166,California,287202,113260,400462,24,12,36
228,14,6/28/43,8/5/43,825178,888165,60835,17580,1791758,1713343,78415,California,304549,120351,424900,24,14,38
229,6,6/29/43,8/6/43,811818,888165,60361,17443,1777787,1699983,77804,California,299681,118582,418263,24,14,38
230,8,6/30/43,8/8/43,824907,888165,60825,17578,1791475,1713072,78403,California,308010,121975,429985,24,15,39
231,5,6/30/43,8/10/43,823468,888165,60774,17563,1789970,1711633,78337,California,307871,122014,429885,25,16,41
232,10,7/4/43,9/4/43,1050003,934797,70474,20366,2075640,1984800,90840,California,408421,172828,581249,37,25,62
233,7,7/8/43,8/12/43,829935,888165,61004,17629,1796733,1718100,78633,California,317390,125627,443017,21,14,35
234,9,7/10/43,9/8/43,993877,934797,68481,19790,2016945,1928674,88271,California,388151,163049,551200,36,24,60
235,2,7/11/43,8/15/43,802879,888165,60043,17352,1768439,1691044,77395,California,310338,122649,432987,20,15,35
236,11,7/12/43,8/17/43,823104,888165,60761,17559,1789589,1711269,78320,California,319881,126347,446228,23,13,36
237,2,7/13/43,8/19/43,797302,888165,59845,17294,1762606,1685467,77139,California,305648,120764,426412,23,14,37
238,12,7/15/43,8/21/43,796766,888165,59830,17291,1762052,1684931,77121,California,308739,121975,430714,24,13,37
239,3,7/18/43,8/22/43,783737,888165,59364,17155,1748421,1671902,76519,California,302725,119599,422324,22,13,35
240,13,7/19/43,8/24/43,772171,888165,58953,17037,1736326,1660336,75990,California,298628,117856,416484,23,13,36
241,4,7/19/43,8/26/43,768832,888165,58834,17002,1732833,1656997,75836,California,298309,117683,415992,24,14,38
242,14,7/22/43,8/30/43,785655,888165,59432,17175,1750427,1673820,76607,California,306825,120870,427695,23,16,39
243,6,7/23/43,8/31/43,780879,888165,59262,17126,1745432,1669044,76388,California,301985,118969,420954,24,15,39
244,8,7/24/43,8/31/43,758285,888165,58460,16894,1721804,1646450,75354,California,293501,115587,409088,24,14,38
245,5,7/25/43,9/6/43,772795,888165,58975,17043,1736978,1660960,76018,California,300413,118425,418838,24,19,43
246,7,7/29/43,9/9/43,780087,888165,59234,17118,1744604,1668252,76352,California,305307,120297,425604,23,19,42
247,1,7/31/43,9/11/43,807182,888165,60196,17396,1772939,1695347,77592,California,314682,123984,438666,23,19,42
248,11,8/4/43,9/12/43,810679,888165,60320,17432,1776596,1698844,77752,California,317071,124880,441951,23,16,39
249,2,8/5/43,9/14/43,810239,888165,60305,17427,1776136,1698404,77732,California,316871,124852,441723,23,17,40
250,12,8/8/43,9/15/43,838362,888165,61303,17716,1805546,1726527,79019,California,330431,130222,460653,22,16,38
251,3,8/9/43,9/17/43,835488,888165,31201,17686,1772540,1723653,48887,California,327107,128982,456089,22,17,39
252,10,8/10/43,9/30/43,1016562,934797,69286,20023,2040668,1951359,89309,California,402298,162913,565211,34,17,51
253,13,8/11/43,10/4/43,1043856,934797,70255,20303,2069211,1978653,90558,California,411070,166449,577519,35,19,54
254,4,8/12/43,9/19/43,853743,888165,31849,17874,1791631,1741908,49723,California,332229,131223,463452,23,15,38
255,14,8/14/43,10/8/43,1027495,934797,69674,20135,2052101,1962292,89809,California,403241,162901,566142,34,21,55
256,9,8/16/43,10/11/43,1046085,934797,70334,20326,2071542,1980882,90660,California,412221,166508,578729,33,23,56
257,6,8/17/43,9/21/43,836125,888165,61224,17693,1803207,1724290,78917,California,323549,128058,451607,22,13,35
258,8,8/18/43,10/14/43,1067057,934797,71079,20541,2093474,2001854,91620,California,419656,169363,589019,34,23,57
259,5,8/18/43,9/23/43,821015,888165,60687,17538,1787405,1709180,78225,California,312931,124087,437018,23,13,36
260,7,8/21/43,9/25/43,847283,888165,61620,17807,1814875,1735448,79427,California,325468,129362,454830,22,13,35
261,1,8/23/43,9/27/43,821390,888165,60701,17542,1787798,1709555,78243,California,309768,123488,433256,22,13,35
262,11,8/27/43,10/17/43,1047282,934797,70377,20338,2072794,1982079,90715,California,404769,163580,568349,31,20,51
263,2,8/28/43,9/30/43,824325,888165,60805,17572,1790867,1712490,78377,California,310099,124328,434427,22,11,33
264,12,8/30/43,10/21/43,1091084,934797,71932,20787,2118600,2025881,92719,California,420082,170138,590220,31,21,52
265,3,8/31/43,10/7/43,930035,888165,64558,18656,1901414,1818200,83214,California,354613,143364,497977,24,13,37
266,4,9/4/43,10/26/43,1101176,934797,72291,20891,2129155,2035973,93182,California,418596,170476,589072,31,21,52
267,6,9/8/43,10/27/43,1089061,934797,71860,20767,2116485,2023858,92627,California,402358,164438,566796,31,18,49
268,5,9/10/43,10/29/43,1026294,934797,69632,20123,2050846,1961091,89755,California,380574,155731,536305,31,18,49
269,10,9/13/43,10/31/43,1011768,934797,69116,19974,2035655,1946565,89090,California,366325,150654,516979,31,17,48
270,7,9/13/43,10/31/43,1016905,934797,69298,20026,2041026,1951702,89324,California,375510,154052,529562,30,18,48
271,1,9/15/43,10/31/43,1007753,934797,68973,19932,2031455,1942550,88905,California,368713,151869,520582,30,16,46
272,13,9/16/43,11/7/43,1009776,934797,69045,19953,2033571,1944573,88998,California,365435,151320,516755,31,21,52
273,14,9/17/43,11/8/43,988715,934797,68297,19737,2011546,1923512,88034,California,356068,147840,503908,31,21,52
274,9,9/18/43,11/12/43,979860,934797,67983,19646,2002286,1914657,87629,California,353038,147281,500319,31,24,55
275,2,9/19/43,11/13/43,1015829,934797,69260,20015,2039901,1950626,89275,California,369429,154577,524006,32,23,55
276,8,9/21/43,11/16/43,1010469,934797,69070,19960,2034296,1945266,89030,California,365279,153459,518738,33,23,56
277,3,9/24/43,11/18/43,1035457,934797,69957,20217,2060428,1970254,90174,California,373541,157561,531102,32,23,55
278,11,9/27/43,11/20/43,984561,934797,68150,19694,2007202,1919358,87844,California,353524,149487,503011,32,22,54
279,12,9/30/43,11/22/43,1030196,934797,69770,20163,2054926,1964993,89933,California,369739,156797,526536,31,22,53
280,4,10/5/43,11/25/43,987055,934797,68239,19720,2009811,1921852,87959,California,354522,150728,505250,28,23,51
281,6,10/9/43,11/26/43,977799,934797,67910,19625,2000131,1912596,87535,California,349515,149143,498658,28,20,48
282,5,10/11/43,11/29/43,990739,934797,68369,19758,2013663,1925536,88127,California,351594,150450,502044,29,20,49
283,7,10/13/43,12/3/43,974294,934797,67785,19589,1996465,1909091,87374,California,346836,148780,495616,27,24,51
284,10,10/14/43,12/12/43,975137,934797,67815,19598,1997347,1909934,87413,California,349482,150035,499517,28,31,59
285,1,10/16/43,12/13/43,1006420,934797,68926,19919,2030062,1941217,88845,California,356490,153348,509838,30,28,58
286,13,10/17/43,12/15/43,1052376,934785,70561,20386,2078108,1987161,90947,California,378055,163254,541309,34,25,59
287,14,10/18/43,12/1/43,877283,888165,62685,18115,1846248,1765448,80800,California,310758,135628,446386,24,20,44
288,9,10/19/43,12/5/43,861283,888165,62117,17951,1829516,1749448,80068,California,302504,132254,434758,25,22,47
289,2,10/21/43,12/7/43,866040,888165,62286,18000,1834491,1754205,80286,California,306146,134147,440293,26,21,47
290,8,10/24/43,12/9/43,872754,888165,62524,18069,1841512,1760919,80593,California,312784,137539,450323,29,17,46
291,3,10/26/43,12/12/43,876907,888165,62672,18111,1845855,1765072,80783,California,315582,138940,454522,28,19,47
292,11,10/29/43,12/18/43,883425,888165,62903,18178,1852671,1771590,81081,California,317101,139669,456770,27,23,50
293,12,10/31/43,12/19/43,895023,888165,63315,18297,1864800,1783188,81612,California,321195,141568,462763,27,22,49
294,4,11/2/43,12/21/43,857909,888165,61997,17916,1825987,1746074,79913,California,302873,133460,436333,26,23,49
295,6,11/6/43,12/22/43,883281,888165,62898,18177,1852521,1771446,81075,California,314875,138837,453712,26,20,46
296,7,11/9/43,12/24/43,861068,888165,62109,17949,1829291,1749233,80058,California,305103,134264,439367,27,18,45
297,5,11/9/43,12/23/43,847447,888165,62626,17809,1816047,1735612,80435,California,301988,133049,435037,25,19,44
298,10,11/11/43,12/27/43,860525,888165,62090,17943,1828723,1748690,80033,California,306465,134748,441213,27,19,46
299,14,11/12/43,12/28/43,848789,888165,61673,17823,1816450,1736954,79496,California,301611,132798,434409,28,18,46
300,9,11/13/43,12/28/43,834701,888165,61173,17678,1801717,1722866,78851,California,297798,131552,429350,28,17,45
301,1,11/15/43,12/30/43,837338,888165,61267,17705,1804475,1725503,78972,California,297667,131862,429529,27,18,45
302,2,11/16/43,12/31/43,812873,888165,60398,17454,1778890,1701038,77852,California,287360,127810,415170,27,18,45
303,13,11/20/43,12/31/43,844358,888165,61516,17777,1811816,1732523,79293,California,303160,134945,438105,27,14,41
304,8,11/22/43,12/31/43,843365,888165,61481,17767,1810778,1731530,79248,California,297783,132973,430756,27,12,39
305,3,11/23/43,12/31/43,862920,888165,62175,17968,1831228,1751085,80143,California,305279,136112,441391,28,10,38
306,11,11/25/43,1/7/44,847051,888165,61612,17805,1814633,1735216,79417,California,301258,134322,435580,27,16,43
307,12,11/27/43,1/9/44,848781,888165,61673,17823,1816442,1736946,79496,California,302366,134601,436967,26,17,43
308,6,12/2/43,1/13/44,902240,888165,63571,18371,1872347,1790405,81942,California,319886,140486,460372,24,18,42
309,5,12/4/43,1/15/44,884491,888165,62941,18189,1853786,1772656,81130,California,312969,136918,449887,24,18,42
310,10,12/8/43,1/18/44,886970,888165,63029,18214,1856378,1775135,81243,California,313368,136984,450352,23,18,41
311,14,12/10/43,1/19/44,868318,888165,62367,18023,1836873,1756483,80390,California,300419,131128,431547,23,17,40
312,9,12/11/43,1/22/44,882850,888165,62883,18172,1852070,1771015,81055,California,307476,131879,439355,25,17,42
313,1,12/12/43,1/24/44,900094,888165,63495,18349,1870103,1788259,81844,California,310460,131692,442152,26,17,43
314,2,12/13/43,1/26/44,898509,888165,63439,18333,1868446,1786674,81772,California,313047,133841,446888,26,18,44
315,13,12/17/43,1/29/44,955967,888165,65479,18922,1928533,1844132,84401,California,329608,136825,466433,28,15,43
316,8,12/19/43,1/31/44,921786,888165,64265,18572,1892788,1809951,82837,California,318997,131520,450517,27,16,43
317,3,12/21/43,2/2/44,964833,888165,65794,19013,1937805,1852998,84807,California,326995,134058,461053,27,16,43
318,11,12/22/43,2/7/44,948495,888165,65214,18846,1920720,1836660,84060,California,326946,131116,458062,28,19,47
319,12,12/23/43,2/8/44,950330,888165,65279,18865,1922639,1838495,84144,California,327945,130656,458601,29,18,47
320,6,12/27/43,2/10/44,957760,888165,65543,18941,1930409,1845925,84484,California,329662,130425,460087,28,17,45
321,5,12/28/43,2/12/44,955548,888165,65464,18918,1928095,1843713,84382,California,331384,129874,461258,30,16,46
322,10,12/31/43,2/15/44,942031,888165,64984,18779,1913959,1830196,83763,California,326355,125622,451977,29,17,46
323,9,1/5/44,2/17/44,940145,888165,64917,18760,1911987,1828310,83677,California,323248,122304,445552,26,17,43
324,1,1/7/44,2/21/44,935448,888165,64750,18712,1907075,1823613,83462,California,326194,121897,448091,28,17,45
325,13,1/14/44,2/26/44,967678,888165,65895,19043,1940781,1855843,84938,California,339880,125040,464920,25,18,43
326,8,1/15/44,2/26/44,943753,888165,65045,18797,1915760,1831918,83842,California,331875,121524,453399,26,16,42
327,11,1/19/44,2/29/44,939099,888165,64880,18749,1910893,1827264,83629,California,329356,120377,449733,24,17,41
328,12,1/21/44,3/6/44,983050,888165,66441,19200,1956856,1871215,85641,California,347413,125370,472783,27,18,45
329,5,1/27/44,3/9/44,974400,888165,66133,19112,1947810,1862565,85245,California,344045,123389,467434,23,19,42
330,10,1/29/44,3/13/44,1015887,888165,67606,19537,1991195,1904052,87143,California,361605,128346,489951,25,19,44
331,9,1/31/44,3/15/44,993396,888165,66808,19307,1967676,1881561,86115,California,350390,123850,474240,25,19,44
332,13,2/9/44,3/23/44,1056406,888165,69045,19953,2033569,1944571,88998,California,366701,129269,495970,24,19,43
333,5,2/10/44,3/29/44,1156582,888165,72602,20981,2138330,2044747,93583,California,362205,131144,493349,26,22,48
334,11,2/12/44,3/29/44,1106227,888165,70814,20464,2085670,1994392,91278,California,375223,133489,508712,27,19,46
335,11,3/11/44,4/28/44,1444669,888165,82831,23937,2439602,2332834,106768,California,350956,126974,477930,27,21,48
336,5,3/17/44,5/4/44,1686152,888165,91405,26415,2692137,2574317,117820,California,349748,125109,474857,28,20,48
1,1,5/22/41,2/17/42,861000,888165,62107,17948.30193,1829220.302,1749165,80055.30193,Carolina,744875,327859,1072734,198,73,271
2,2,5/22/41,3/12/42,861000,888165,62107,17948.30193,1829220.302,1749165,80055.30193,Carolina,648993,241625,890618,240,54,294
3,3,5/28/41,3/27/42,861000,888165,62107,17948.30193,1829220.302,1749165,80055.30193,Carolina,585777,199917,785694,251,52,303
4,4,8/22/41,4/7/42,861000,888165,62107,17948.30193,1829220.302,1749165,80055.30193,Carolina,557964,172563,730527,183,45,228
5,5,9/3/41,4/16/42,861000,888161,62107,17948.30193,1829216.302,1749161,80055.30193,Carolina,536140,159480,695620,186,39,225
6,6,9/4/41,4/27/42,861000,888165,62107,17948.30193,1829220.302,1749165,80055.30193,Carolina,522386,152308,674694,199,36,235
7,7,9/22/41,5/6/42,861000,888165,62107,17948.30193,1829220.302,1749165,80055.30193,Carolina,505175,143246,648421,188,38,226
8,8,9/23/41,5/11/42,861000,888165,62107,17948.30193,1829220.302,1749165,80055.30193,Carolina,503251,142950,646201,201,29,230
9,9,10/1/41,5/21/42,861000,888165,62107,17948.30193,1829220.302,1749165,80055.30193,Carolina,493264,138662,631926,207,25,232
10,1,12/11/41,5/28/42,861000,888165,62107,17948.30193,1829220.302,1749165,80055.30193,Carolina,485827,135860,621687,150,18,168
11,2,1/22/42,6/4/42,861000,888165,62107,17948.30193,1829220.302,1749165,80055.30193,Carolina,484127,136079,620206,115,18,133
12,3,2/5/42,6/11/42,861000,888165,62107,17948.30193,1829220.302,1749165,80055.30193,Carolina,466637,129993,596630,106,20,126
13,4,2/25/42,6/17/42,861000,888165,62107,17948.30193,1829220.302,1749165,80055.30193,Carolina,457400,125363,582763,95,17,112
14,5,3/10/42,6/24/42,861000,888165,62107,17948.30193,1829220.302,1749165,80055.30193,Carolina,420863,115631,536494,89,17,106
15,6,3/24/42,6/30/42,861000,888165,62107,17948.30193,1829220.302,1749165,80055.30193,Carolina,427913,115481,543394,82,16,98
16,7,3/30/42,7/8/42,861000,888165,62107,17948.30193,1829220.302,1749165,80055.30193,Carolina,429610,115975,545585,83,17,100
17,8,4/13/42,7/14/42,861000,888165,62107,17948.30193,1829220.302,1749165,80055.30193,Carolina,442895,120212,563107,76,16,92
18,9,4/27/42,7/20/42,861000,888165,62107,17948.30193,1829220.302,1749165,80055.30193,Carolina,435678,116679,552357,67,17,84
19,1,5/11/42,7/24/42,861000,888165,62107,17948.30193,1829220.302,1749165,80055.30193,Carolina,434087,117472,551559,57,17,74
20,2,5/18/42,7/29/42,861000,888165,62107,17948.30193,1829220.302,1749165,80055.30193,Carolina,447083,119501,566584,55,17,72
21,3,5/23/42,8/5/42,861000,888165,62107,17948.30193,1829220.302,1749165,80055.30193,Carolina,476599,127869,604468,57,17,74
22,4,6/1/42,8/15/42,861000,888165,62107,17948.30193,1829220.302,1749165,80055.30193,Carolina,493930,134000,627930,55,20,75
23,5,6/8/42,8/21/42,861000,888165,62107,17948.30193,1829220.302,1749165,80055.30193,Carolina,492636,136805,629441,55,19,74
24,6,6/15/42,8/28/42,861000,888165,62107,17948.30193,1829220.302,1749165,80055.30193,Carolina,500837,143782,644619,62,12,74
25,7,6/22/42,9/7/42,861000,888165,62107,17948.30193,1829220.302,1749165,80055.30193,Carolina,489128,141803,630931,62,15,77
26,8,6/29/42,9/12/42,861000,888165,62107,17948.30193,1829220.302,1749165,80055.30193,Carolina,474280,139983,614263,62,13,75
27,9,7/4/42,9/17/42,861000,888165,62107,17948.30193,1829220.302,1749165,80055.30193,Carolina,463579,135174,598753,63,12,75
28,1,7/8/42,9/23/42,861000,888165,62107,17948.30193,1829220.302,1749165,80055.30193,Carolina,440371,131636,572007,65,12,77
29,2,7/12/42,9/29/42,861000,888165,62107,17948.30193,1829220.302,1749165,80055.30193,Carolina,415636,124255,539891,67,12,79
30,3,7/19/42,10/4/42,861000,888165,62107,17948.30193,1829220.302,1749165,80055.30193,Carolina,421394,124243,545637,66,11,77
31,4,7/26/42,10/10/42,861000,888165,62107,17948.30193,1829220.302,1749165,80055.30193,Carolina,430348,126890,557238,65,11,76
32,5,8/2/42,10/15/42,861000,888165,62107,17948.30193,1829220.302,1749165,80055.30193,Carolina,416287,120361,536648,63,11,74
33,6,8/16/42,10/21/42,861000,888165,62107,17948.30193,1829220.302,1749165,80055.30193,Carolina,411515,119196,530711,55,11,66
34,7,8/23/42,10/24/42,861000,888165,62107,17948.30193,1829220.302,1749165,80055.30193,Carolina,402536,114802,517338,53,9,62
35,8,8/30/42,10/29/42,861000,888165,62107,17948.30193,1829220.302,1749165,80055.30193,Carolina,402223,113403,515626,51,9,60
36,9,9/5/42,11/4/42,861000,888165,62107,17948.30193,1829220.302,1749165,80055.30193,Carolina,392248,110708,502956,50,10,60
37,1,9/11/42,11/7/42,861000,888165,62107,17948.30193,1829220.302,1749165,80055.30193,Carolina,365778,105148,470926,47,10,57
38,2,9/17/42,11/12/42,777436,888165,59140,17090.8686,1741831.869,1665601,76230.8686,Carolina,400401,116426,516827,45,11,56
39,3,9/23/42,11/20/42,749785,888165,58158,16807.08042,1712915.08,1637950,74965.08042,Carolina,387350,109849,497199,44,14,58
40,4,9/29/42,11/24/42,795981,888165,59798,17281.02402,1761225.024,1684146,77079.02402,Carolina,411890,117059,528949,43,13,56
41,5,10/4/42,11/27/42,753263,888165,58282,16842.91518,1716552.915,1641428,75124.91518,Carolina,393218,110161,503379,42,12,54
42,6,10/10/42,11/30/42,764924,888165,58696,16962.55704,1728747.557,1653089,75658.55704,Carolina,393537,111263,504800,41,10,51
43,7,10/15/42,12/4/42,719100,888165,57069,16492.37031,1680826.37,1607265,73561.37031,Carolina,370916,105160,476076,40,10,50
44,8,10/20/42,12/9/42,705161,888165,56574,16349.32026,1666249.32,1593326,72923.32026,Carolina,363230,102468,465698,38,12,50
45,9,10/25/42,12/12/42,677641,888165,55596,16066.68804,1637468.688,1565806,71662.68804,Carolina,344978,98295,443273,35,13,48
46,1,10/28/42,12/15/42,703412,888165,56512,16331.40288,1664420.403,1591577,72843.40288,Carolina,356511,103014,459525,34,14,48
47,2,11/2/42,12/20/42,699922,888165,56388,16295.56812,1660770.568,1588087,72683.56812,Carolina,356789,101116,457905,34,14,48
48,3,11/6/42,12/22/42,711194,888165,56788,16411.16412,1672558.164,1599359,73199.16412,Carolina,362377,103345,465722,34,12,46
49,4,11/11/42,12/27/42,722607,888165,57193,16528.20507,1684493.205,1610772,73721.20507,Carolina,370261,105402,475663,32,14,46
50,5,11/15/42,12/31/42,738087,888165,57743,16687.14957,1700682.15,1626252,74430.14957,Carolina,375266,106400,481666,33,13,46
51,6,11/20/42,12/31/42,724987,888165,57278,16552.76922,1686982.769,1613152,73830.76922,Carolina,362336,102785,465121,32,9,41
52,7,11/24/42,1/7/43,711258,888165,56790,16411.7421,1672624.742,1599423,73201.7421,Carolina,354634,100087,454721,30,14,44
53,8,11/27/42,1/10/43,705909,888165,56600,16356.834,1667030.834,1594074,72956.834,Carolina,353300,100602,453902,30,14,44
54,9,11/29/42,1/13/43,741505,888165,57864,16722.11736,1704256.117,1629670,74586.11736,Carolina,373308,106956,480264,31,14,45
55,1,12/1/42,1/16/43,695130,888165,56217,16246.15083,1655758.151,1583295,72463.15083,Carolina,343333,102113,445446,35,11,46
56,2,12/6/42,1/19/43,722565,888165,57192,16527.91608,1684449.916,1610730,73719.91608,Carolina,353688,105052,458740,34,10,44
57,3,12/10/42,1/23/43,699548,888165,56374,16291.52226,1660378.522,1587713,72665.52226,Carolina,341303,102059,443362,34,10,44
58,4,12/13/42,1/26/43,688236,888165,55973,16175.63727,1648549.637,1576401,72148.63727,Carolina,336567,100388,436955,35,9,44
59,5,12/18/42,1/29/43,690998,888165,56071,16203.95829,1651437.958,1579163,72274.95829,Carolina,336374,100201,436575,32,10,42
60,6,12/22/42,1/31/43,717752,888165,57021,16478.49879,1679416.499,1605917,73499.49879,Carolina,344164,106241,450405,30,10,40
61,7,12/24/42,2/3/43,668673,888165,55278,15974.78922,1628090.789,1556838,71252.78922,Carolina,322593,96510,419103,31,10,41
62,8,12/27/42,2/6/43,687654,888165,55952,16169.56848,1647940.568,1575819,72121.56848,Carolina,328070,97879,425949,30,11,41
63,9,12/30/42,2/9/43,693865,888165,56173,16233.43527,1654436.435,1582030,72406.43527,Carolina,332483,100464,432947,31,10,41
64,1,1/5/43,2/13/43,688224,888165,55972,16175.34828,1648536.348,1576389,72147.34828,Carolina,330943,101395,432338,29,10,39
65,2,1/9/43,2/16/43,677505,888165,55592,16065.53208,1637327.532,1565670,71657.53208,Carolina,320734,98377,419111,28,10,38
66,3,1/13/43,2/18/43,672525,888165,55415,16014.38085,1632119.381,1560690,71429.38085,Carolina,320728,97999,418727,28,8,36
67,4,1/17/43,2/21/43,667624,888165,55251,15966.98649,1627006.986,1555789,71217.98649,Carolina,317826,96335,414161,27,8,35
68,5,1/19/43,2/24/43,667910,888165,55596,16066.68804,1627737.688,1556075,71662.68804,Carolina,319346,98297,417643,28,8,36
69,6,1/21/43,2/27/43,677412,888165,55588,16064.37612,1637229.376,1565577,71652.37612,Carolina,320629,99927,420556,29,8,37
70,7,1/24/43,3/2/43,696759,888165,56275,16262.91225,1657461.912,1584924,72537.91225,Carolina,325152,101496,426648,29,8,37
71,8,1/26/43,3/6/43,663738,888165,55103,15924.21597,1622930.216,1551903,71027.21597,Carolina,311362,95610,406972,30,9,39
72,9,1/30/43,3/9/43,680489,888165,55698,16096.16502,1640448.165,1568654,71794.16502,Carolina,323996,99443,423439,29,9,38
73,1,2/3/43,3/12/43,668683,888165,55278,15974.78922,1628100.789,1556848,71252.78922,Carolina,316209,100305,416514,30,7,37
74,2,2/6/43,3/16/43,679854,888165,55675,16089.51825,1639783.518,1568019,71764.51825,Carolina,322272,98581,420853,31,7,38
75,3,2/11/43,3/19/43,673476,888165,55449,16024.20651,1633114.207,1561641,71473.20651,Carolina,314217,97600,411817,29,7,36
76,4,2/13/43,3/22/43,675745,888165,55529,16047.32571,1635486.326,1563910,71576.32571,Carolina,317621,96433,414054,30,7,37
77,5,2/16/43,3/25/43,665212,888165,55155,15939.24345,1624471.243,1553377,71094.24345,Carolina,314028,95407,409435,30,7,37
78,6,2/19/43,3/28/43,675542,888165,55522,16045.30278,1635274.303,1563707,71567.30278,Carolina,316656,96027,412683,30,7,37
79,7,2/22/43,3/31/43,681401,888165,55730,16105.4127,1641401.413,1569566,71835.4127,Carolina,323048,96781,419829,30,7,37
80,8,2/25/43,4/5/43,727093,888165,57352,16574.15448,1689184.154,1615258,73926.15448,Carolina,346404,106035,452439,31,8,39
81,9,2/28/43,4/8/43,701412,888165,56441,16310.88459,1662328.885,1589577,72751.88459,Carolina,335664,98623,434287,31,8,39
82,1,3/5/43,4/13/43,721410,888165,57151,16516.06749,1683242.067,1609575,73667.06749,Carolina,344831,103610,448441,32,7,39
83,2,3/9/43,4/15/43,698044,888165,56321,16276.20579,1658806.206,1586209,72597.20579,Carolina,324367,97488,421855,31,6,37
84,3,3/12/43,4/19/43,691420,888165,56086,16208.29314,1651879.293,1579585,72294.29314,Carolina,321733,94842,416575,31,7,38
85,4,3/16/43,4/21/43,677449,888165,55590,16064.9541,1637268.954,1565614,71654.9541,Carolina,315280,92462,407742,29,7,36
86,5,3/18/43,4/24/43,697907,888165,56316,16274.76084,1658662.761,1586072,72590.76084,Carolina,323554,95863,419417,30,7,37
87,6,3/22/43,4/26/43,673082,888165,55435,16020.16065,1632702.161,1561247,71455.16065,Carolina,306316,87414,393730,28,7,35
88,7,3/24/43,4/28/43,665167,888165,55154,15938.95446,1624424.954,1553332,71092.95446,Carolina,301224,86316,387540,29,6,35
89,8,3/29/43,4/30/43,652153,888165,54692,15805.44108,1610815.441,1540318,70497.44108,Carolina,301844,86572,388416,26,6,32
90,9,4/1/43,5/4/43,693002,888165,56138,16223.32062,1653528.321,1581167,72361.32062,Carolina,323450,93476,416926,26,7,33
91,1,4/7/43,5/7/43,700327,888165,56402,16299.61398,1661193.614,1588492,72701.61398,Carolina,328335,103724,432059,23,7,30
92,2,4/10/43,5/11/43,634610,888165,54069,15625.40031,1592469.4,1522775,69694.40031,Carolina,303866,88254,392120,24,7,31
93,3,4/13/43,5/14/43,656528,888165,54847,15850.23453,1615390.235,1544693,70697.23453,Carolina,311478,91671,403149,24,7,31
94,4,4/15/43,5/16/43,637498,888165,54171,15654.87729,1595488.877,1525663,69825.87729,Carolina,305337,89799,395136,25,6,31
95,5,4/18/43,5/19/43,636508,888165,54136,15644.76264,1594453.763,1524673,69780.76264,Carolina,298818,89637,388455,25,6,31
96,6,4/20/43,5/21/43,633343,888165,54024,15612.39576,1591144.396,1521508,69636.39576,Carolina,299141,89256,388397,25,6,31
97,7,4/23/43,5/24/43,633574,888165,54032,15614.70768,1591385.708,1521739,69646.70768,Carolina,296361,87349,383710,25,6,31
98,8,4/26/43,5/27/43,625691,888165,53752,15533.79048,1583141.79,1513856,69285.79048,Carolina,291725,86900,378625,25,6,31
99,9,4/28/43,5/29/43,612145,888165,53271,15394.78629,1568975.786,1500310,68665.78629,Carolina,284270,83592,367862,25,6,31
100,1,5/1/43,5/31/43,668301,888165,55265,15971.03235,1627702.032,1556466,71236.03235,Carolina,307006,93177,400183,24,6,30
101,2,5/5/43,6/4/43,606299,888165,53063,15334.67637,1562861.676,1494464,68397.67637,Carolina,277032,81932,358964,24,6,30
102,3,5/8/43,6/6/43,631776,888165,53968,15596.21232,1589505.212,1519941,69564.21232,Carolina,285466,85045,370511,23,6,29
103,4,5/11/43,6/10/43,670780,888165,55352,15996.17448,1630293.174,1558945,71348.17448,Carolina,301334,92117,393451,24,6,30
104,5,5/14/43,6/14/43,663994,888165,55112,15926.81688,1623197.817,1552159,71038.81688,Carolina,305814,93086,398900,25,6,31
105,6,5/16/43,6/17/43,659767,888165,54962,15883.46838,1618777.468,1547932,70845.46838,Carolina,305294,94711,400005,26,6,32
106,7,5/19/43,6/20/43,640836,888165,54290,15689.2671,1598980.267,1529001,69979.2671,Carolina,291377,91136,382513,26,6,32
107,8,5/22/43,6/23/43,643549,888165,54386,15717.01014,1601817.01,1531714,70103.01014,Carolina,293095,91471,384566,26,6,32
108,9,5/24/43,6/27/43,675035,888165,55504,16040.10096,1634744.101,1563200,71544.10096,Carolina,309463,97015,406478,27,7,34
109,1,5/26/43,6/30/43,670894,888165,55357,15997.61943,1630413.619,1559059,71354.61943,Carolina,308755,97469,406224,29,6,35
110,2,5/30/43,7/5/43,701850,888165,56456,16315.21944,1662786.219,1590015,72771.21944,Carolina,323708,104411,428119,28,8,36
111,3,5/31/43,7/7/43,653835,888165,54751,15822.49149,1612573.491,1542000,70573.49149,Carolina,299511,94767,394278,30,7,37
112,4,6/5/43,7/10/43,675102,888165,55506,16040.67894,1634813.679,1563267,71546.67894,Carolina,311058,99672,410730,28,7,35
113,5,6/9/43,7/15/43,660979,888165,55005,15895.89495,1620044.895,1549144,70900.89495,Carolina,299982,95374,395356,29,7,36
114,6,6/12/43,7/18/43,671556,888165,55380,16004.2662,1631105.266,1559721,71384.2662,Carolina,299682,98251,397933,29,7,36
115,7,6/15/43,7/22/43,664494,888165,55130,15932.0187,1623721.019,1552659,71062.0187,Carolina,298272,99946,398218,30,7,37
116,8,6/18/43,7/28/43,684121,888165,55827,16133.44473,1644246.445,1572286,71960.44473,Carolina,305759,101360,407119,33,7,40
117,9,6/21/43,7/31/43,662876,888165,55072,15915.25728,1622028.257,1551041,70987.25728,Carolina,289842,99821,389663,33,7,40
118,1,6/25/43,7/25/43,657394,888165,54878,15859.19322,1616296.193,1545559,70737.19322,Carolina,293728,97622,391350,22,8,30
119,2,6/28/43,8/12/43,670307,888165,55336,15991.55064,1629799.551,1558472,71327.55064,Carolina,298307,102250,400557,29,16,45
120,3,7/1/43,8/8/43,711202,888165,56788,16411.16412,1672566.164,1599367,73199.16412,Carolina,310082,107061,417143,30,8,38
121,4,7/4/43,8/12/43,678304,888165,55620,16073.6238,1638162.624,1566469,71693.6238,Carolina,296918,104065,400983,31,8,39
122,5,7/9/43,8/15/43,674846,888165,55497,16038.07803,1634546.078,1563011,71535.07803,Carolina,298103,103076,401179,29,8,37
123,6,7/12/43,8/19/43,691742,888165,56097,16211.47203,1652215.472,1579907,72308.47203,Carolina,302421,107715,410136,30,8,38
124,7,7/16/43,8/22/43,741787,888165,57874,16725.00726,1704551.007,1629952,74599.00726,Carolina,325894,118798,444692,29,8,37
125,8,7/22/43,8/26/43,747122,888165,58064,16779.91536,1710130.915,1635287,74843.91536,Carolina,331444,120743,452187,27,8,35
126,9,7/25/43,8/27/43,837250,888165,61264,17704.68336,1804383.683,1725415,78968.68336,Carolina,374062,137601,511663,27,6,33
1,1,10/1/41,5/31/42,1796653,888165,95239,27523.11861,2807580.119,2684818,122762.1186,Delta,1022302,386657,1408959,178,64,242
2,2,10/16/41,6/25/42,1681465,888165,91239,26367.15861,2687236.159,2569630,117606.1586,Delta,938537,354975,1293512,189,63,252
3,3,11/6/41,7/7/42,1638463,888165,89712,25925.87088,2642265.871,2526628,115637.8709,Delta,918857,347531,1266388,184,59,243
4,4,12/22/41,7/21/42,1661780,888165,90540,26165.1546,2666650.155,2549945,116705.1546,Delta,924353,349610,1273963,145,66,211
5,5,1/19/42,7/29/42,1512170,888165,85228,24630.03972,2510193.04,2400335,109858.0397,Delta,824018,311661,1135679,131,60,191
6,6,2/2/42,8/7/42,1434196,888165,82459,23829.82641,2428649.826,2322361,106288.8264,Delta,771109,291650,1062759,133,53,186
7,1,4/1/42,8/19/42,1550109,888165,86575,25019.30925,2549868.309,2438274,111594.3093,Delta,837564,316784,1154348,105,35,140
8,2,4/25/42,8/29/42,1391833,888165,80955,23395.18545,2384348.185,2279998,104350.1855,Delta,729493,275910,1005403,96,30,126
9,7,5/9/42,9/30/42,1375206,888165,80365,23224.68135,2366960.681,2263371,103589.6814,Delta,689588,250697,940285,121,23,144
10,3,5/11/42,9/5/42,1328469,888165,78705,22744.95795,2318083.958,2216634,101449.958,Delta,689720,260867,950587,89,28,117
11,8,5/14/42,9/26/42,1392375,888165,80974,23400.67626,2384914.676,2280540,104374.6763,Delta,709947,258098,968045,108,27,135
12,4,5/17/42,9/12/42,1353809,888165,79605,23005.04895,2344584.049,2241974,102610.049,Delta,694161,262547,956708,84,34,118
13,5,5/31/42,9/19/42,1311098,888165,78088,22566.65112,2299917.651,2199263,100654.6511,Delta,654420,247516,901936,81,30,111
14,6,6/16/42,10/11/42,1356540,888165,79702,23033.08098,2347440.081,2244705,102735.081,Delta,658809,249175,907984,83,34,117
15,1,7/16/42,10/21/42,1435875,888165,82519,23847.16581,2430406.166,2324040,106366.1658,Delta,684159,258764,942923,72,25,97
16,2,8/1/42,10/31/42,1456820,888165,83262,24061.88538,2452308.885,2344985,107323.8854,Delta,685260,259180,944440,70,21,91
17,3,8/9/42,10/29/42,1270990,888165,76664,22155.12936,2257974.129,2159155,98819.12936,Delta,579752,219275,799027,61,20,81
18,4,8/10/42,11/5/42,1293106,888165,77450,22382.2755,2281103.276,2181271,99832.2755,Delta,580537,219572,800109,65,22,87
19,5,8/20/42,11/10/42,1230943,888165,75242,21744.18558,2216094.186,2119108,96986.18558,Delta,544023,205761,749784,61,21,82
20,8,8/31/42,11/18/42,1303919,888165,77834,22493.24766,2292411.248,2192084,100327.2477,Delta,581806,211513,793319,57,22,79
21,6,9/8/42,11/28/42,1230340,888165,75221,21738.11679,2215464.117,2118505,96959.11679,Delta,554432,209698,764130,60,21,81
22,7,9/8/42,11/24/42,1255206,888165,76104,21993.29496,2241468.295,2143371,98097.29496,Delta,561473,204121,765594,59,18,77
23,1,9/27/42,12/7/42,1271183,888165,76671,22157.15229,2258176.152,2159348,98828.15229,Delta,574680,217356,792036,57,14,71
24,3,10/10/42,12/11/42,1103602,888165,70721,20437.66179,2082925.662,1991767,91158.66179,Delta,493589,186686,680275,47,15,62
25,2,10/11/42,12/24/42,1241930,888165,75633,21857.18067,2227585.181,2130095,97490.18067,Delta,559055,211447,770502,57,17,74
26,4,10/15/42,12/18/42,1130452,888165,71674,20713.06926,2111004.069,2018617,92387.06926,Delta,503136,190297,693433,49,15,64
27,5,10/21/42,12/30/42,1109468,888165,70930,20498.0607,2089061.061,1997633,91428.0607,Delta,491987,186080,678067,52,18,70
28,8,10/28/42,12/31/42,1156661,888165,72605,20982.11895,2138413.119,2044826,93587.11895,Delta,506263,184050,690313,47,17,64
29,7,11/7/42,1/11/43,1230227,888165,75217,21736.96083,2215345.961,2118392,96953.96083,Delta,541394,196822,738216,46,19,65
30,6,11/8/42,1/15/43,1148321,888165,72309,20896.57791,2129691.578,2036486,93205.57791,Delta,513194,194102,707296,46,22,68
31,1,11/24/42,1/21/43,1182582,888165,73525,21247.98975,2165519.99,2070747,94772.98975,Delta,529264,200178,729442,44,14,58
32,3,11/27/42,1/29/43,1066738,888165,69412,20059.37388,2044374.374,1954903,89471.37388,Delta,489062,155794,644856,44,19,63
33,4,12/4/42,1/30/43,1053582,888165,68945,19924.41555,2030616.416,1941747,88869.41555,Delta,483152,153912,637064,43,14,57
34,2,12/8/42,2/4/43,1093241,888165,70353,20331.31347,2072090.313,1981406,90684.31347,Delta,501666,159810,661476,41,17,58
35,5,12/13/42,2/11/43,1087129,888165,70136,20268.60264,2065698.603,1975294,90404.60264,Delta,495901,157974,653875,40,20,60
36,8,12/15/42,2/17/43,1202254,888165,74224,21449.99376,2186092.994,2090419,95673.99376,Delta,529201,192389,721590,46,18,64
37,7,12/29/42,2/24/43,1169946,888165,73077,21118.52223,2152306.522,2058111,94195.52223,Delta,514406,187011,701417,43,14,57
38,6,1/4/43,2/28/43,1090668,888165,70262,20305.01538,2069400.015,1978833,90567.01538,Delta,510431,162602,673033,39,16,55
39,1,1/9/43,3/31/43,1149108,888165,72337,20904.66963,2130514.67,2037273,93241.66963,Delta,538360,171499,709859,46,35,81
40,3,1/16/43,3/20/43,1060884,888165,69204,19999.26396,2038252.264,1949049,89203.26396,Delta,496451,158148,654599,47,16,63
41,4,1/20/43,3/17/43,1011431,888165,67448,19491.79752,1986535.798,1899596,86939.79752,Delta,471534,150211,621745,40,16,56
42,2,1/25/43,3/26/43,1064437,888165,69330,20035.6767,2041967.677,1952602,89365.6767,Delta,500551,159455,660006,40,20,60
43,5,1/27/43,3/29/43,995726,888165,66891,19330.83009,1970112.83,1883891,86221.83009,Delta,462745,147411,610156,45,16,61
44,8,2/4/43,4/22/43,1079661,888165,69871,20192.02029,2057889.02,1967826,90063.02029,Delta,493889,157332,651221,41,36,77
45,7,2/16/43,4/15/43,1079476,888165,69864,20189.99736,2057694.997,1967641,90053.99736,Delta,495577,157871,653448,41,17,58
46,6,2/17/43,4/10/43,959443,888165,65602,18958.32198,1932168.322,1847608,84560.32198,Delta,444527,141608,586135,38,14,52
47,1,2/26/43,4/24/43,1058775,888165,69129,19977.58971,2036046.59,1946940,89106.58971,Delta,495529,157854,653383,39,18,57
48,4,3/3/43,4/24/43,1004028,888165,67185,19415.79315,1978793.793,1892193,86600.79315,Delta,463561,147671,611232,38,14,52
49,3,3/6/43,5/5/43,1046386,888165,68689,19850.43411,2023090.434,1934551,88539.43411,Delta,479539,152761,632300,47,13,60
50,2,3/9/43,4/30/43,991107,888165,66726,19283.14674,1965281.147,1879272,86009.14674,Delta,452053,144005,596058,38,14,52
51,5,3/16/43,5/8/43,940262,888165,64921,18761.51979,1912109.52,1828427,83682.51979,Delta,423931,135047,558978,36,17,53
52,8,3/18/43,5/12/43,1052785,888165,68918,19916.61282,2029784.613,1940950,88834.61282,Delta,474073,151020,625093,37,18,55
53,6,3/29/43,5/19/43,890123,888165,63141,18247.11759,1859676.118,1778288,81388.11759,Delta,397445,126610,524055,33,18,51
54,7,3/30/43,5/22/43,1025228,888165,67938,19633.40262,2000964.403,1913393,87571.40262,Delta,457602,145773,603375,32,21,53
55,1,4/7/43,5/25/43,1025631,888165,67952,19637.44848,2001385.448,1913796,87589.44848,Delta,463427,147629,611056,33,15,48
56,4,4/11/43,5/29/43,973323,888165,66095,19100.79405,1946683.794,1861488,85195.79405,Delta,438487,139683,578170,36,12,48
57,2,4/17/43,5/30/43,1050183,888165,68824,19889.44776,2027061.448,1938348,88713.44776,Delta,473234,150752,623986,31,12,43
58,5,4/22/43,6/11/43,1010516,888165,67416,19482.54984,1985579.55,1898681,86898.54984,Delta,458618,146097,604715,32,18,50
59,3,4/23/43,6/18/43,1054049,888165,68961,19929.03939,2031104.039,1942214,88890.03939,Delta,488202,155520,643722,40,16,56
60,8,4/25/43,6/23/43,1179472,888165,73415,21216.20085,2162268.201,2067637,94631.20085,Delta,538631,171585,710216,41,18,59
61,6,5/2/43,6/25/43,968491,888165,65924,19051.37676,1941631.377,1856656,84975.37676,Delta,458173,121730,579903,35,19,54
62,7,5/3/43,6/28/43,1110337,888165,70960,20506.7304,2089968.73,1998502,91466.7304,Delta,499546,159134,658680,36,20,56
63,1,5/11/43,7/6/43,1083144,888165,69995,20227.85505,2061531.855,1971309,90222.85505,Delta,525438,139601,665039,36,20,56
64,4,5/18/43,9/4/43,1488186,934797,86032,24862.38768,2533877.388,2422983,110894.3877,Delta,738859,196304,935163,50,59,109
65,2,5/19/43,9/13/43,1538544,934797,87820,25379.1018,2586540.102,2473341,113199.1018,Delta,764744,203181,967925,52,65,117
66,5,5/25/43,9/16/43,1432425,934797,84052,24290.18748,2475564.187,2367222,108342.1875,Delta,700985,186241,887226,50,64,114
67,3,6/3/43,9/22/43,1499146,934797,86421,24974.80479,2545338.805,2433943,111395.8048,Delta,736793,195755,932548,52,59,111
68,6,6/7/43,9/28/43,1435066,934797,84146,24317.35254,2478326.353,2369863,108463.3525,Delta,707378,187940,895318,54,59,113
69,8,6/7/43,10/8/43,1599292,934797,89977,26002.45323,2650068.453,2534089,115979.4532,Delta,780604,207395,987999,59,64,123
70,7,6/9/43,10/6/43,1484978,934797,85918,24829.44282,2530522.443,2419775,110747.4428,Delta,720400,191400,911800,59,60,119
71,1,6/17/43,10/16/43,1482632,934797,85835,24805.45665,2528069.457,2417429,110640.4567,Delta,726945,193138,920083,58,63,121
72,4,7/8/43,10/20/43,1378338,934797,82132,23735.32668,2419002.327,2313135,105867.3267,Delta,666484,177075,843559,49,55,104
73,2,7/11/43,10/25/43,1398059,934797,82832,23937.61968,2439625.62,2332856,106769.6197,Delta,675735,179533,855268,52,54,106
74,5,7/15/43,11/12/43,1274976,934797,78462,22674.73338,2310909.733,2209773,101136.7334,Delta,604479,160601,765080,49,71,120
75,3,7/26/43,10/30/43,1352766,934797,81224,23472.92376,2392259.924,2287563,104696.9238,Delta,647937,172147,820084,52,44,96
76,1,8/1/43,11/7/43,1271806,934797,78349,22642.07751,2307594.078,2206603,100991.0775,Delta,603766,155437,759203,49,49,98
77,7,8/6/43,11/13/43,1408699,934797,83210,24046.8579,2450752.858,2343496,107256.8579,Delta,665033,176690,841723,48,51,99
78,6,8/8/43,11/15/43,1343090,934797,80880,23373.5112,2382140.511,2277887,104253.5112,Delta,637755,164184,801939,48,51,99
79,2,8/16/43,11/16/43,1299802,934797,79343,22929.33357,2336871.334,2234599,102272.3336,Delta,620736,159803,780539,47,45,92
80,8,8/27/43,11/27/43,1267505,934797,78196,22597.86204,2303095.862,2202302,100793.862,Delta,606315,156090,762405,43,49,92
81,3,9/2/43,11/22/43,1276775,934797,78525,22692.93975,2312789.94,2211572,101217.9398,Delta,604060,155508,759568,43,38,81
82,4,9/3/43,11/30/43,1222005,934797,76581,22131.14319,2255514.143,2156802,98712.14319,Delta,574585,147922,722507,45,43,88
83,1,9/15/43,12/13/43,1167738,934797,74654,21574.25946,2198763.259,2102535,96228.25946,Delta,550379,141690,692069,45,44,89
84,5,9/18/43,12/15/43,1208342,934797,76096,21990.98304,2241225.983,2143139,98086.98304,Delta,569847,146702,716549,45,43,88
85,6,9/26/43,12/20/43,1261654,934797,77989,22538.04111,2296978.041,2196451,100527.0411,Delta,589911,151867,741778,47,38,85
86,7,9/28/43,12/17/43,1254511,934797,77735,22464.63765,2289507.638,2189308,100199.6377,Delta,586144,150893,737037,39,41,80
87,2,10/5/43,12/16/43,1180639,934797,75112,21706.61688,2212254.617,2115436,96818.61688,Delta,544757,140242,684999,45,27,72
88,8,10/11/43,1/4/44,1169280,934797,74709,21590.15391,2200376.154,2104077,96299.15391,Delta,543287,139864,683151,46,39,85
89,4,10/19/43,1/6/44,1172894,934797,74836,21626.85564,2204153.856,2107691,96462.85564,Delta,545414,140412,685826,44,35,79
90,3,10/20/43,1/15/44,1221219,934797,76553,22123.05147,2254692.051,2156016,98676.05147,Delta,575278,148101,723379,46,41,87
91,1,10/31/43,1/13/44,1165584,934797,74577,21552.00723,2196510.007,2100381,96129.00723,Delta,549988,141589,691577,45,29,74
92,5,11/1/43,1/13/44,1237245,934797,77122,22287.48678,2271451.487,2172042,99409.48678,Delta,588502,151509,740011,45,28,73
93,7,11/7/43,2/10/44,1267984,934797,78213,22602.77487,2303596.775,2202781,100815.7749,Delta,596331,153520,749851,55,40,95
94,6,11/13/43,1/26/44,1291294,934797,79041,22842.05859,2327974.059,2226091,101883.0586,Delta,615097,158351,773448,45,29,74
95,4,11/16/43,1/31/44,1184078,934797,75234,21741.87366,2215850.874,2118875,96975.87366,Delta,564035,146337,710372,44,32,76
96,8,11/25/43,2/9/44,1014672,888165,67563,19525.03137,1989925.031,1902837,87088.03137,Delta,491177,126449,617626,44,32,76
97,2,12/4/43,2/21/44,1006226,888165,67263,19438.33437,1981092.334,1894391,86701.33437,Delta,517797,136253,654050,49,30,79
98,7,12/5/43,3/7/44,1101541,888165,70648,20416.56552,2080770.566,1989706,91064.56552,Delta,563289,148224,711513,54,39,93
99,8,12/16/43,3/5/44,1013906,888165,67536,19517.22864,1989124.229,1902071,87053.22864,Delta,522103,137387,659490,55,25,80
100,5,12/18/43,3/6/44,1066677,888165,69410,20058.7959,2044310.796,1954842,89468.7959,Delta,547333,144026,691359,49,30,79
101,3,12/24/43,3/24/44,1073238,888165,69643,20126.13057,2051172.131,1961403,89769.13057,Delta,545090,143435,688525,54,37,91
102,4,1/10/44,3/20/44,938887,888165,64872,18747.35928,1910671.359,1827052,83619.35928,Delta,476653,125426,602079,40,30,70
103,1,1/10/44,3/22/44,1004636,888165,67207,19422.15093,1979430.151,1892801,86629.15093,Delta,508654,133848,642502,48,24,72
104,6,1/10/44,3/29/44,1093475,888165,69210,20000.9979,2070850.998,1981640,89210.9979,Delta,554909,146019,700928,50,29,79
105,5,1/24/44,4/10/44,975324,888165,66166,19121.31234,1948776.312,1863489,85287.31234,Delta,491121,129233,620354,42,35,77
106,2,1/27/44,4/26/44,1034510,888165,68268,19728.76932,2010671.769,1922675,87996.76932,Delta,523073,137641,660714,44,46,90
107,6,2/5/44,4/21/44,963990,855740,64612,18672.22188,1903014.222,1819730,83284.22188,Delta,486610,128046,614656,45,31,76
108,3,2/11/44,4/24/44,1043472,855740,67435,19488.04065,1986135.041,1899212,86923.04065,Delta,528713,139125,667838,45,28,73
109,8,2/18/44,4/30/44,1001200,855740,65934,19054.26666,1941928.267,1856940,84988.26666,Delta,500199,133480,633679,41,31,72
110,4,2/21/44,5/19/44,1035169,888165,68291,19735.41609,2011360.416,1923334,88026.41609,Delta,524604,139994,664598,44,44,88
111,1,2/28/44,5/17/44,1021467,888165,67805,19594.96695,1997031.967,1909632,87399.96695,Delta,512194,136682,648876,45,34,79
112,7,3/6/44,5/31/44,1108124,888165,70882,20484.18918,2087655.189,1996289,91366.18918,Delta,550006,146344,696350,45,41,86
113,5,3/7/44,5/21/44,999569,888165,67027,19370.13273,1974131.133,1887734,86397.13273,Delta,501773,133900,635673,41,34,75
114,2,3/13/44,6/5/44,1044686,888165,68629,19833.09471,2021313.095,1932851,88462.09471,Delta,522469,139017,661486,45,39,84
115,6,3/22/44,6/22/44,1000253,888165,67051,19377.06849,1974846.068,1888418,86428.06849,Delta,503353,132675,636028,41,51,92
116,3,3/28/44,7/5/44,1079104,888165,69851,20186.24049,2057306.24,1967269,90037.24049,Delta,548195,144494,692689,48,51,99
117,8,3/31/44,7/6/44,1074696,888165,69695,20141.15805,2052697.158,1962861,89836.15805,Delta,540741,142529,683270,46,51,97
118,4,4/6/44,7/20/44,1002916,888165,67146,19404.52254,1977631.523,1891081,86550.52254,Delta,502605,131076,633681,40,65,105
119,1,4/14/44,7/22/44,1065058,888165,69352,20042.03448,2042617.034,1953223,89394.03448,Delta,534698,140936,675634,38,61,99
120,5,4/18/44,7/17/44,1011513,888165,67451,19492.66449,1986621.664,1899678,86943.66449,Delta,512574,135105,647679,45,45,90
121,7,4/21/44,7/26/44,1109124,888165,70917,20494.30383,2088700.304,1997289,91411.30383,Delta,562121,146597,708718,59,37,96
122,2,4/28/44,8/5/44,1079067,888165,69850,20185.9515,2057267.952,1967232,90035.9515,Delta,551442,143812,695254,54,45,99
123,6,5/3/44,8/1/44,976225,888165,66198,19130.56002,1949718.56,1864390,85328.56002,Delta,496035,129363,625398,50,40,90
124,3,5/16/44,8/22/44,1050682,888165,68842,19894.64958,2027583.65,1938847,88736.64958,Delta,536932,140028,676960,52,46,98
125,8,5/17/44,8/26/44,1074147,888165,68675,19846.38825,2050833.388,1962312,88521.38825,Delta,545787,141241,687028,52,49,101
126,4,5/17/44,8/22/44,986504,888165,66563,19236.04137,1960468.041,1874669,85799.04137,Delta,502271,129979,632250,45,52,97
127,1,5/23/44,8/28/44,1026177,888165,67972,19643.22828,2001957.228,1914342,87615.22828,Delta,521835,135043,656878,50,47,97
128,5,6/3/44,9/4/44,1011036,888165,67434,19487.75166,1986122.752,1899201,86921.75166,Delta,510787,132183,642970,45,48,93
129,7,6/20/44,8/31/44,1081114,888165,69922,20206.75878,2059407.759,1969279,90128.75878,Delta,544227,140837,685064,43,29,72
130,2,6/22/44,9/12/44,1035430,888165,68300,19738.017,2011633.017,1923595,88038.017,Delta,521392,134928,656320,39,43,82
131,6,6/23/44,9/15/44,963165,888165,65735,18996.75765,1936061.758,1851330,84731.75765,Delta,489767,123234,613001,41,43,84
132,4,7/3/44,9/19/44,951573,888165,65323,18877.69377,1923938.694,1839738,84200.69377,Delta,483839,121742,605581,40,38,78
133,3,7/8/44,9/26/44,1001305,888165,67091,19388.62809,1975949.628,1889470,86479.62809,Delta,511793,128777,640570,40,40,80
134,8,7/10/44,10/2/44,1030030,888165,68109,19682.81991,2005986.82,1918195,87791.81991,Delta,518543,130475,649018,42,42,84
135,1,7/13/44,10/4/44,984568,888165,66494,19216.10106,1958443.101,1872733,85710.10106,Delta,501136,126095,627231,41,42,83
136,5,7/19/44,10/17/44,989801,888165,66680,19269.8532,1963915.853,1877966,85949.8532,Delta,504917,127046,631963,40,50,90
137,2,8/1/44,10/16/44,1019997,888165,67752,19579.65048,1995493.65,1908162,87331.65048,Delta,520470,130959,651429,41,35,76
138,7,8/3/44,10/25/44,1025695,888165,67955,19638.31545,2001453.315,1913860,87593.31545,Delta,520361,130932,651293,42,41,83
139,6,8/4/44,10/19/44,953454,888165,65390,18897.0561,1925906.056,1841619,84287.0561,Delta,483351,120092,603443,40,36,76
140,4,8/14/44,10/27/44,941110,888165,64951,18770.18949,1912996.189,1829275,83721.18949,Delta,474025,117775,591800,42,32,74
141,3,8/18/44,10/31/44,996137,888165,66905,19334.87595,1970541.876,1884302,86239.87595,Delta,500084,124249,624333,39,35,74
142,8,8/22/44,11/7/44,1039425,888165,68442,19779.05358,2015811.054,1927590,88221.05358,Delta,526345,130774,657119,41,36,77
143,1,8/24/44,11/13/44,968753,888165,65933,19053.97767,1941904.978,1856918,84986.97767,Delta,493222,122544,615766,44,37,81
144,5,8/29/44,11/14/44,943074,888165,95021,27460.11879,1953720.119,1831239,122481.1188,Delta,475645,118178,593823,41,36,77
145,2,9/12/44,11/18/44,967315,888165,65882,19039.23918,1940401.239,1855480,84921.23918,Delta,489854,116772,606626,42,25,67
146,6,9/14/44,11/20/44,923596,888165,64330,18590.7267,1894681.727,1811761,82920.7267,Delta,465423,110948,576371,37,30,67
147,7,9/15/44,3/12/45,1929034,876731,99623,28790.05077,2934178.051,2805765,128413.0508,Delta,923416,239973,1163389,94,84,178
148,4,9/25/44,11/25/44,945278,888165,65099,18812.96001,1917354.96,1833443,83911.96001,Delta,477165,113747,590912,42,19,61
149,3,9/27/44,11/30/44,941907,888165,64980,18778.5702,1913830.57,1830072,83758.5702,Delta,469905,112017,581922,40,24,64
150,1,10/9/44,12/9/44,950453,888165,65283,18866.13417,1922767.134,1838618,84149.13417,Delta,483327,115216,598543,40,21,61
151,5,10/10/44,12/12/44,975887,888165,66186,19127.09214,1949365.092,1864052,85313.09214,Delta,497932,118697,616629,40,23,63
152,2,10/25/44,12/21/44,972282,888165,66058,19090.10142,1945595.101,1860447,85148.10142,Delta,482423,114989,597412,40,17,57
153,8,10/30/44,12/27/44,988781,888165,66644,19259.44956,1962849.45,1876946,85903.44956,Delta,499996,119189,619185,39,19,58
154,6,10/31/44,12/26/44,974476,888165,66136,19112.64264,1947889.643,1862641,85248.64264,Delta,493370,117610,610980,40,16,56
155,4,11/7/44,12/28/44,952459,888165,65354,18886.65246,1924864.652,1840624,84240.65246,Delta,470400,112123,582523,34,17,51
156,3,11/7/44,12/31/44,946142,888165,65130,18821.9187,1918258.919,1834307,83951.9187,Delta,467023,111318,578341,34,20,54
157,8,11/13/44,1/13/45,1046589,888165,68697,19852.74603,2023303.746,1934754,88549.74603,Delta,529156,126128,655284,40,21,61
158,5,11/20/44,2/11/45,1598458,876731,87886,25398.17514,2588473.175,2475189,113284.1751,Delta,751151,195205,946356,65,18,83
159,1,11/20/44,1/20/45,1000356,888165,67055,19378.22445,1974954.224,1888521,86433.22445,Delta,507038,120856,627894,39,22,61
160,6,12/4/44,1/29/45,995699,888165,66890,19330.5411,1970084.541,1883864,86220.5411,Delta,503212,119850,623062,38,18,56
161,2,12/5/44,1/31/45,968907,888165,65938,19055.42262,1942065.423,1857072,84993.42262,Delta,488556,116360,604916,39,18,57
162,4,12/12/44,4/17/45,1569622,876731,86862,25102.24938,2558317.249,2446353,111964.2494,Delta,743385,193187,936572,71,55,126
163,3,12/12/44,2/9/45,963315,888165,65740,18998.2026,1936218.203,1851480,84738.2026,Delta,486198,115798,601996,42,17,59
164,7,12/19/44,4/27/45,1502298,876731,84471,24411.27429,2487911.274,2379029,108882.2743,Delta,706043,457346,1163389,71,58,129
165,8,12/26/44,2/22/45,992378,888165,66772,19296.44028,1966611.44,1880543,86068.44028,Delta,503084,119820,622904,41,17,58
166,1,12/30/44,2/28/45,950494,888165,65258,18858.90942,1922775.909,1838659,84116.90942,Delta,474746,113649,588395,39,21,60
167,6,1/12/45,5/8/45,1379965,876731,80128,23156.19072,2359980.191,2256696,103284.1907,Delta,642830,167055,809885,60,56,116
168,2,1/15/45,3/13/45,934869,888165,64730,18706.3227,1906470.323,1823034,83436.3227,Delta,467318,111871,579189,38,19,57
169,3,1/24/45,5/4/45,991858,888165,66753,19290.94947,1966066.949,1880023,86043.94947,Delta,462811,110494,573305,35,65,100
170,5,1/25/45,5/16/45,1296075,876731,77149,22295.28951,2272250.29,2172806,99444.28951,Delta,597152,155185,752337,54,57,111
171,8,2/6/45,5/24/45,1281332,876731,76626,22144.14774,2256833.148,2158063,98770.14774,Delta,588559,152952,741511,56,51,107
172,1,2/8/45,5/31/45,1347355,876731,78970,22821.5403,2325877.54,2224086,101791.5403,Delta,624991,162419,787410,58,54,112
173,4,2/22/45,6/7/45,1256541,876731,75745,21889.54755,2230906.548,2133272,97634.54755,Delta,575964,149678,725642,55,50,105
174,2,2/23/45,6/16/45,1261114,876731,75908,21936.65292,2235689.653,2137845,97844.65292,Delta,577525,150084,727609,57,56,113
175,7,3/1/45,6/25/45,1191111,876731,73422,21218.22378,2162482.224,2067842,94640.22378,Delta,542208,140906,683114,55,61,116
176,3,3/1/45,6/30/45,1208304,876731,74033,21394.79667,2180462.797,2085035,95427.79667,Delta,549996,142930,692926,58,63,121
177,6,3/14/45,7/9/45,1187911,876731,73309,21185.56791,2159136.568,2064642,94494.56791,Delta,537790,139758,677548,55,62,117
178,5,3/21/45,7/18/45,1177613,876731,72943,21079.79757,2148366.798,2054344,94022.79757,Delta,532759,138450,671209,57,62,119
179,8,4/4/45,7/25/45,1192874,876731,73485,21236.43015,2164326.43,2069605,94721.43015,Delta,545159,141673,686832,59,53,112
180,1,4/9/45,7/31/45,1241361,876731,75206,21733.78194,2215031.782,2118092,96939.78194,Delta,570223,148186,718409,64,49,113
181,4,4/19/45,8/17/45,1209886,876731,74089,21410.98011,2182116.98,2086617,95499.98011,Delta,557236,144812,702048,58,62,120
182,2,4/23/45,8/25/45,1232235,876731,74882,21640.14918,2205488.149,2108966,96522.14918,Delta,571006,148390,719396,66,58,124
183,7,4/26/45,8/31/45,1174655,876731,72838,21049.45362,2145273.454,2051386,93887.45362,Delta,543697,141293,684990,64,63,127
184,3,4/30/45,9/12/45,1247463,876731,75423,21796.49277,2221413.493,2124194,97219.49277,Delta,574653,149338,723991,72,63,135
185,6,5/9/45,9/24/45,1249809,876731,75506,21820.47894,2223866.479,2126540,97326.47894,Delta,582749,151441,734190,69,69,138
186,5,5/18/45,9/29/45,1283179,876731,76691,22162.93209,2258763.932,2159910,98853.93209,Delta,600777,156127,756904,73,61,134
187,1,6/13/45,10/10/45,1306926,876731,77534,22406.55066,2283597.551,2183657,99940.55066,Delta,610811,158734,769545,62,57,119
188,4,6/18/45,10/13/45,1328002,876731,78283,22623.00417,2305639.004,2204733,100906.0042,Delta,623586,162054,785640,68,49,117
1,6,7/18/41,5/27/42,1540267,883896,86074,24875.386,2535112.386,2424163,110949.386,Houston,885562,311089,1196651,254,59,313
2,5,7/18/41,6/2/42,1487866,883896,84213,24337.557,2480312.557,2371762,108550.557,Houston,864085,299406,1163491,275,44,319
3,4,7/25/41,6/17/42,1469769,883896,83571,24152.019,2461388.019,2353665,107723.019,Houston,841542,295371,1136913,278,49,327
4,3,7/25/41,6/22/42,1474167,883896,83727,24197.103,2465987.103,2358063,107924.103,Houston,847164,296352,1143516,291,41,332
5,2,10/23/41,6/30/42,1486197,883896,84154,24320.506,2478567.506,2370093,108474.506,Houston,846052,299034,1145086,211,39,250
6,1,10/23/41,7/16/42,1474590,883896,83742,24201.438,2466429.438,2358486,107943.438,Houston,826250,296446,1122696,218,48,266
7,7,10/23/41,7/13/42,1431969,883896,82229,23764.181,2421858.181,2315865,105993.181,Houston,815185,286985,1102170,211,52,263
8,8,12/30/41,7/22/42,1440569,883896,82534,23852.326,2430851.326,2324465,106386.326,Houston,815502,288903,1104405,164,40,204
9,9,12/30/41,7/28/42,1478538,883896,83882,24241.898,2470557.898,2362434,108123.898,Houston,837216,297369,1134585,171,39,210
10,6,4/3/42,8/4/42,1483001,883896,84041,24287.849,2475225.849,2366897,108328.849,Houston,810607,298321,1108928,91,32,123
11,5,4/24/42,8/11/42,1519999,883896,85354,24667.306,2513916.306,2403895,110021.306,Houston,839308,306570,1145878,78,31,109
12,4,5/4/42,8/19/42,1534184,883896,85858,24812.962,2528750.962,2418080,110670.962,Houston,839684,309732,1149416,82,25,107
13,3,5/18/42,8/26/42,1493538,883896,84415,24395.935,2486244.935,2377434,108810.935,Houston,801135,300670,1101805,76,24,100
14,2,5/26/42,8/31/42,1511002,883896,85035,24575.115,2504508.115,2394898,109610.115,Houston,796110,304564,1100674,78,19,97
15,7,6/2/42,9/9/42,1480163,883896,83940,24258.66,2472257.66,2364059,108198.66,Houston,774625,297732,1072357,78,21,99
16,1,6/9/42,9/15/42,1479117,883896,83903,24247.967,2471163.967,2363013,108150.967,Houston,772608,297455,1070063,74,24,98
17,8,6/16/42,9/21/42,1464704,883896,83391,24099.999,2456090.999,2348600,107490.999,Houston,752038,294284,1046322,76,21,97
18,9,6/23/42,9/24/42,1428932,883896,82121,23732.969,2418681.969,2312828,105853.969,Houston,730513,286308,1016821,76,17,93
19,6,7/4/42,9/30/42,1353397,883896,79439,22957.871,2339689.871,2237293,102396.871,Houston,677941,269426,947367,69,19,88
20,5,7/13/42,10/8/42,1375505,883896,80224,23184.736,2362809.736,2259401,103408.736,Houston,685620,274355,959975,67,20,87
21,4,7/27/42,10/20/42,1409743,883896,81439,23535.871,2398613.871,2293639,104974.871,Houston,695274,281989,977263,57,28,85
22,3,8/3/42,10/28/42,1423679,883896,81934,23678.926,2413187.926,2307575,105612.926,Houston,707684,285095,992779,64,22,86
23,2,8/13/42,10/31/42,1468271,883895,83518,24136.702,2459820.702,2352166,107654.702,Houston,716784,295038,1011822,63,16,79
24,7,8/19/42,11/16/42,1483167,883896,84046,24289.294,2475398.294,2367063,108335.294,Houston,729326,298402,1027728,69,20,89
25,1,8/24/42,11/20/42,1457528,883895,83136,24026.304,2448585.304,2341423,107162.304,Houston,713360,292642,1006002,68,20,88
26,8,9/3/42,11/26/42,1434581,883896,82321,23790.769,2424588.769,2318477,106111.769,Houston,694497,287568,982065,69,15,84
27,9,9/8/42,11/28/42,1429779,883896,82151,23741.639,2419567.639,2313675,105892.639,Houston,680659,286497,967156,69,12,81
28,6,9/15/42,11/30/42,1356263,883895,79540,22987.06,2342685.06,2240158,102527.06,Houston,653797,270065,923862,62,14,76
29,5,9/22/42,12/8/42,1401700,883895,81154,23453.506,2390202.506,2285595,104607.506,Houston,676659,280195,956854,59,18,77
30,4,10/5/42,12/19/42,1429163,883895,82129,23735.281,2418922.281,2313058,105864.281,Houston,689783,286318,976101,58,17,75
31,3,10/12/42,12/30/42,1432100,883895,82233,23765.337,2421993.337,2315995,105998.337,Houston,690228,286973,977201,61,18,79
32,2,10/19/42,12/31/42,1409575,883895,81433,23534.137,2398437.137,2293470,104967.137,Houston,675112,281952,957064,60,13,73
33,7,10/28/42,1/6/43,1403941,883896,81233,23476.337,2392546.337,2287837,104709.337,Houston,669972,280736,950708,54,16,70
34,1,11/2/42,1/14/43,1358194,883895,79609,23007.001,2344705.001,2242089,102616.001,Houston,654026,270496,924522,58,15,73
35,8,11/12/42,1/20/43,1353162,883896,79430,22955.27,2339443.27,2237058,102385.27,Houston,646484,269413,915897,55,14,69
36,6,11/17/42,1/16/43,1320627,883895,78275,22621.475,2305418.475,2204522,100896.475,Houston,624888,262123,887011,50,10,60
37,9,11/17/42,1/28/43,1369356,883896,80005,23121.445,2356378.445,2253252,103126.445,Houston,651221,273023,924244,56,16,72
38,5,11/23/42,1/31/43,1281787,883896,76896,22222.944,2264801.944,2165683,99118.944,Houston,579855,244136,823991,59,10,69
39,4,12/3/42,2/12/43,1253407,883896,75888,21931.632,2235122.632,2137303,97819.632,Houston,571677,238057,809734,56,15,71
40,3,12/14/42,2/20/43,1214732,883896,74515,21534.835,2194677.835,2098628,96049.835,Houston,552966,229774,782740,53,15,68
41,2,12/19/42,2/25/43,1217528,883896,74615,21563.735,2197602.735,2101424,96178.735,Houston,552730,230373,783103,53,15,68
42,7,12/22/42,2/28/43,1185298,883896,73470,21232.83,2163896.83,2069194,94702.83,Houston,538768,223469,762237,55,13,68
43,1,12/31/42,2/28/43,1131338,883896,71554,20679.106,2107467.106,2015234,92233.106,Houston,515601,211912,727513,50,9,59
44,8,1/7/43,3/11/43,1125416,883896,71344,20618.416,2101274.416,2009312,91962.416,Houston,510474,210643,721117,48,15,63
45,6,1/8/43,3/14/43,1125619,883896,71351,20620.439,2101486.439,2009515,91971.439,Houston,512660,210687,723347,51,14,65
46,9,1/13/43,3/17/43,1137809,883896,71784,20745.576,2114234.576,2021705,92529.576,Houston,513338,213297,726635,51,12,63
47,5,1/22/43,3/22/43,1102119,883896,70517,20379.413,2076911.413,1986015,90896.413,Houston,503756,205653,709409,43,16,59
48,4,1/29/43,3/31/43,1103421,883896,70563,20392.707,2078272.707,1987317,90955.707,Houston,502014,205932,707946,46,15,61
49,3,2/6/43,4/8/43,1117762,883896,71072,20539.808,2093269.808,2001658,91611.808,Houston,511207,209004,720211,41,20,61
50,2,2/11/43,4/16/43,1144874,883896,72035,20818.115,2121623.115,2028770,92853.115,Houston,516268,214811,731079,46,18,64
51,7,2/16/43,4/19/43,1084587,883896,69894,20199.366,2058576.366,1968483,90093.366,Houston,494209,201898,696107,43,19,62
52,1,2/20/43,4/23/43,1088625,883895,70038,20240.982,2062798.982,1972520,90278.982,Houston,491122,202763,693885,44,18,62
53,8,2/25/43,4/25/43,1057828,883895,68944,19924.816,2030591.816,1941723,88868.816,Houston,477432,196167,673599,44,15,59
54,6,3/1/43,4/30/43,1066713,883895,69260,20016.14,2039884.14,1950608,89276.14,Houston,478283,198070,676353,44,16,60
55,9,3/6/43,5/8/43,1093429,883895,70208,20290.112,2067822.112,1977324,90498.112,Houston,495967,203792,699759,42,21,63
56,5,3/8/43,5/12/43,1097239,883895,70343,20329.127,2071806.127,1981134,90672.127,Houston,500973,204608,705581,46,19,65
57,4,3/17/43,5/17/43,1084359,883895,69886,20197.054,2058337.054,1968254,90083.054,Houston,490413,201850,692263,44,17,61
58,3,3/20/43,5/21/43,1113428,883895,70918,20495.302,2088736.302,1997323,91413.302,Houston,499829,208076,707905,45,17,62
59,2,3/30/43,5/27/43,1107195,883895,70697,20431.433,2082218.433,1991090,91128.433,Houston,492690,206741,699431,43,15,58
60,7,4/1/43,5/30/43,1120719,883895,71177,20570.153,2096361.153,2004614,91747.153,Houston,504222,209633,713855,43,16,59
61,1,4/6/43,5/31/43,1080634,883895,69754,20158.906,2054441.906,1964529,89912.906,Houston,485333,201052,686385,41,14,55
62,8,4/12/43,6/8/43,1020050,883895,67603,19537.267,1991085.267,1903945,87140.267,Houston,454117,188076,642193,42,15,57
63,6,4/15/43,6/11/43,1035459,883895,68150,19695.35,2007199.35,1919354,87845.35,Houston,463425,191376,654801,42,15,57
64,9,4/19/43,6/14/43,1009360,883895,67223,19427.447,1979905.447,1893255,86650.447,Houston,454024,185786,639810,40,16,56
65,5,4/24/43,6/21/43,1043972,883895,68452,19782.628,2016101.628,1927867,88234.628,Houston,470208,193199,663407,40,18,58
66,4,5/1/43,6/25/43,1048436,883895,68611,19828.579,2020770.579,1932331,88439.579,Houston,471218,194156,665374,38,17,55
67,3,5/5/43,6/29/43,1028319,883896,67896,19621.944,1999732.944,1912215,87517.944,Houston,459202,189846,649048,41,14,55
68,2,5/13/43,6/30/43,1037184,883896,68211,19712.979,2009003.979,1921080,87923.979,Houston,462404,191745,654149,37,11,48
69,7,5/15/43,7/10/43,1040570,883896,68331,19747.659,2012544.659,1924466,88078.659,Houston,464543,192472,657015,40,16,56
70,1,5/18/43,7/14/43,1041264,883896,68356,19754.884,2013270.884,1925160,88110.884,Houston,461484,186238,647722,43,14,57
71,8,5/25/43,7/17/43,1022961,883896,67706,19567.034,1994130.034,1906857,87273.034,Houston,451079,182453,633532,41,12,53
72,6,5/28/43,7/23/43,1041289,883896,68357,19755.173,2013297.173,1925185,88112.173,Houston,459875,186243,646118,39,17,56
73,9,5/31/43,7/27/43,1036854,883896,68199,19709.511,2008658.511,1920750,87908.511,Houston,455717,185326,641043,42,15,57
74,5,6/4/43,8/5/43,1039132,883896,68280,19732.92,2011040.92,1923028,88012.92,Houston,455935,185797,641732,41,21,62
75,4,6/9/43,8/7/43,1032103,883896,68031,19660.959,2003690.959,1915999,87691.959,Houston,451684,184343,636027,38,21,59
76,3,6/16/43,8/13/43,1048432,883896,68610,19828.29,2020766.29,1932328,88438.29,Houston,458022,187720,645742,40,18,58
77,2,6/21/43,8/20/43,1055282,883896,68854,19898.806,2027930.806,1939178,88752.806,Houston,460172,189137,649309,46,14,60
78,7,6/25/43,8/24/43,1068690,883896,69330,20036.37,2041952.37,1952586,89366.37,Houston,465831,191910,657741,46,14,60
79,1,7/1/43,8/28/43,1092727,883896,70183,20282.887,2067088.887,1976623,90465.887,Houston,476684,196881,673565,44,14,58
80,8,7/6/43,8/31/43,1100623,883896,70464,20364.096,2075347.096,1984519,90828.096,Houston,480252,198514,678766,44,12,56
81,6,7/7/43,9/4/43,1099454,883896,70422,20351.958,2074123.958,1983350,90773.958,Houston,479471,198272,677743,45,14,59
82,9,7/13/43,9/14/43,1116382,883896,71023,20525.647,2091826.647,2000278,91548.647,Houston,486708,201773,688481,44,19,63
83,5,7/16/43,9/16/43,1130765,883896,71534,20673.326,2106868.326,2014661,92207.326,Houston,492427,204747,697174,46,16,62
84,4,7/19/43,9/25/43,1142860,883896,71963,20797.307,2119516.307,2026756,92760.307,Houston,496524,207249,703773,49,19,68
85,3,7/27/43,9/30/43,1152141,883896,72293,20892.677,2129222.677,2036037,93185.677,Houston,498733,209168,707901,48,17,65
86,2,8/7/43,10/6/43,1156950,883896,72464,20942.096,2134252.096,2040846,93406.096,Houston,500007,210162,710169,48,12,60
87,7,8/11/43,10/12/43,1158868,883896,72532,20961.748,2136257.748,2042764,93493.748,Houston,500553,210559,711112,48,14,62
88,1,8/16/43,10/15/43,1159449,883896,72552,20967.528,2136864.528,2043345,93519.528,Houston,500640,210679,711319,49,11,60
89,8,8/20/43,10/19/43,1160104,883896,72576,20974.464,2137550.464,2044000,93550.464,Houston,501058,210814,711872,47,13,60
90,6,8/23/43,10/25/43,1160327,883896,72583,20976.487,2137782.487,2044223,93559.487,Houston,501926,210860,712786,49,14,63
91,9,8/27/43,10/28/43,1165847,883895,72779,21033.131,2143554.131,2049742,93812.131,Houston,505106,212002,717108,49,13,62
92,5,9/1/43,10/30/43,1166848,883895,72815,21043.535,2144601.535,2050743,93858.535,Houston,505568,212209,717777,48,11,59
93,4,9/7/43,11/6/43,1162658,883895,72666,21000.474,2140219.474,2046553,93666.474,Houston,504010,211343,715353,46,14,60
94,3,9/14/43,11/11/43,1151483,883895,72269,20885.741,2128532.741,2035378,93154.741,Houston,497596,209032,706628,44,14,58
95,2,9/25/43,11/17/43,1129481,883895,71488,20660.032,2105524.032,2013376,92148.032,Houston,484909,204482,689391,42,11,53
96,7,9/29/43,11/20/43,1123411,883895,71273,20597.897,2099176.897,2007306,91870.897,Houston,481401,203227,684628,42,10,52
97,1,10/5/43,11/25/43,1108761,883895,70753,20447.617,2083856.617,1992656,91200.617,Houston,472431,200197,672628,39,12,51
98,8,10/7/43,11/27/43,1106981,883895,70689,20429.121,2081994.121,1990876,91118.121,Houston,470726,199829,670555,42,9,51
99,6,10/12/43,11/30/43,1100201,883895,70449,20359.761,2074904.761,1984096,90808.761,Houston,466436,198426,664862,39,10,49
100,9,10/16/43,12/8/43,1093801,883895,70221,20293.869,2068210.869,1977696,90514.869,Houston,463478,197105,660583,41,12,53
101,5,10/20/43,12/11/43,1030749,883895,67983,19647.087,2002274.087,1914644,87630.087,Houston,432981,166488,599469,41,11,52
102,4,10/25/43,12/17/43,1021145,883895,67642,19548.538,1992230.538,1905040,87190.538,Houston,428490,164682,593172,43,10,53
103,3,10/29/43,12/22/43,1016316,883895,67470,19498.83,1987179.83,1900211,86968.83,Houston,426910,163774,590684,44,10,54
104,2,11/8/43,12/29/43,1012316,883895,67329,19458.081,1982998.081,1896211,86787.081,Houston,425740,163023,588763,39,12,51
105,1,11/11/43,12/31/43,1011369,883896,67294,19447.966,1982006.966,1895265,86741.966,Houston,426043,162845,588888,37,13,50
106,7,11/14/43,12/31/43,1011005,883896,67282,19444.498,1981627.498,1894901,86726.498,Houston,426364,162776,589140,37,10,47
107,8,11/19/43,1/19/44,999918,883896,66888,19330.632,1970032.632,1883814,86218.632,Houston,425213,160908,586121,47,14,61
108,6,11/22/43,1/22/44,994400,883896,66692,19273.988,1964261.988,1878296,85965.988,Houston,424253,159946,584199,47,14,61
109,9,11/27/43,1/29/44,985586,883896,66379,19183.531,1955044.531,1869482,85562.531,Houston,423538,158514,582052,52,11,63
110,5,12/1/43,1/31/44,980080,883896,66184,19127.176,1949287.176,1863976,85311.176,Houston,426057,158006,584063,51,10,61
111,4,12/8/43,2/9/44,981576,883896,66237,19142.493,1950851.493,1865472,85379.493,Houston,427385,158289,585674,51,12,63
112,3,12/13/43,2/15/44,977017,883896,66075,19095.675,1946083.675,1860913,85170.675,Houston,424507,157430,581937,52,12,64
113,2,12/18/43,2/21/44,975952,883896,66037,19084.693,1944969.693,1859848,85121.693,Houston,424945,157606,582551,53,12,65
114,7,12/20/43,2/25/44,974378,883896,65981,19068.509,1943323.509,1858274,85049.509,Houston,423663,157310,580973,55,12,67
115,1,12/22/43,2/29/44,982812,883896,66281,19155.209,1952144.209,1866708,85436.209,Houston,423301,158144,581445,57,12,69
116,9,1/19/44,3/15/44,980772,883896,66208,19134.112,1950010.112,1864668,85342.112,Houston,424067,157986,582053,43,13,56
117,5,1/22/44,3/17/44,967134,883896,65724,18994.236,1935748.236,1851030,84718.236,Houston,419533,156475,576008,42,13,55
118,4,1/29/44,3/22/44,965996,883896,65683,18982.387,1934557.387,1849892,84665.387,Houston,417635,156036,573671,41,12,53
119,3,2/4/44,3/25/44,959559,883896,65455,18916.495,1927826.495,1843455,84371.495,Houston,415843,155277,571120,39,11,50
120,2,2/10/44,3/30/44,978389,883896,66123,19109.547,1947517.547,1862285,85232.547,Houston,423411,157388,580799,37,12,49
121,7,2/14/44,4/5/44,956527,883896,65347,18885.283,1924655.283,1840423,84232.283,Houston,414608,155008,569616,37,14,51
122,1,2/18/44,4/7/44,954039,883896,65259,18859.851,1922053.851,1837935,84118.851,Houston,412184,154390,566574,38,11,49
123,8,2/23/44,4/12/44,952289,883896,65197,18841.933,1920223.933,1836185,84038.933,Houston,410042,153910,563952,36,13,49
124,6,2/24/44,4/15/44,948410,883896,65059,18802.051,1916167.051,1832306,83861.051,Houston,408931,153332,562263,40,11,51
125,9,3/3/44,4/20/44,945386,883896,64952,18771.128,1913005.128,1829282,83723.128,Houston,406000,152688,558688,36,12,48
126,5,3/6/44,4/26/44,941440,883896,64812,18730.668,1908878.668,1825336,83542.668,Houston,404942,152472,557414,39,12,51
127,4,3/11/44,4/29/44,942500,883896,64849,18741.361,1909986.361,1826396,83590.361,Houston,404359,152371,556730,39,10,49
128,3,3/15/44,5/5/44,941343,883896,64808,18729.512,1908776.512,1825239,83537.512,Houston,403504,152078,555582,41,10,51
129,2,3/20/44,5/11/44,934590,883896,64568,18660.152,1901714.152,1818486,83228.152,Houston,401244,151260,552504,39,13,52
130,7,3/23/44,5/15/44,934477,883896,64564,18658.996,1901595.996,1818373,83222.996,Houston,400992,151164,552156,41,12,53
131,1,3/28/44,5/19/44,927119,883896,64303,18583.567,1893901.567,1811015,82886.567,Houston,397222,149706,546928,41,11,52
132,8,3/31/44,5/23/44,924371,883896,64205,18555.245,1891027.245,1808267,82760.245,Houston,394641,148964,543605,41,12,53
133,6,4/4/44,6/2/44,969983,883896,65825,19023.425,1938727.425,1853879,84848.425,Houston,422146,157086,579232,44,15,59
134,6,4/5/44,5/26/44,919313,883896,64026,18503.514,1885738.514,1803209,82529.514,Houston,393192,148389,541581,40,11,51
135,8,4/6/44,6/6/44,973807,883896,65961,19062.729,1942726.729,1857703,85023.729,Houston,423376,157353,580729,47,14,61
136,9,4/8/44,5/30/44,917565,883896,63964,18485.596,1883910.596,1801461,82449.596,Houston,392102,147909,540011,39,13,52
137,5,4/14/44,5/31/44,913634,883896,63824,18445.136,1879799.136,1797530,82269.136,Houston,390425,147171,537596,38,9,47
138,4,4/19/44,6/7/44,907814,883896,63618,18385.602,1873713.602,1791710,82003.602,Houston,387624,146152,533776,37,12,49
139,3,4/26/44,6/12/44,901509,883896,63394,18320.866,1867119.866,1785405,81714.866,Houston,384334,144741,529075,35,12,47
140,2,4/29/44,6/15/44,896004,883896,63198,18264.222,1861362.222,1779900,81462.222,Houston,382762,144082,526844,36,11,47
141,7,5/4/44,6/17/44,894189,883896,63134,18245.726,1859464.726,1778085,81379.726,Houston,381393,143516,524909,33,11,44
142,1,5/9/44,6/21/44,890119,883896,62989,18203.821,1855207.821,1774015,81192.821,Houston,379203,142751,521954,34,9,43
143,8,5/12/44,6/26/44,890418,883896,63000,18207,1855521,1774314,81207,Houston,378775,142582,521357,34,11,45
144,6,5/16/44,6/29/44,887685,883896,62903,18178.967,1852662.967,1771581,81081.967,Houston,378239,142368,520607,34,10,44
145,9,5/18/44,6/30/44,888089,883896,62917,18183.013,1853085.013,1771985,81100.013,Houston,377667,142144,519811,36,7,43
146,5,5/23/44,7/8/44,883785,883896,62764,18138.796,1848583.796,1767681,80902.796,Houston,377033,141861,518894,35,11,46
147,4,5/27/44,7/12/44,885216,883890,62815,18153.535,1850074.535,1769106,80968.535,Houston,377276,141979,519255,34,12,46
148,3,6/1/44,7/19/44,888047,883896,62915,18182.435,1853040.435,1771943,81097.435,Houston,378324,142437,520761,37,11,48
149,2,6/5/44,7/24/44,887757,883896,62905,18179.545,1852737.545,1771653,81084.545,Houston,379438,142908,522346,37,12,49
150,7,6/7/44,7/28/44,887345,883896,62891,18175.499,1852307.499,1771241,81066.499,Houston,379068,142756,521824,40,11,51
151,1,6/13/44,7/31/44,891143,883896,63026,18214.514,1856279.514,1775039,81240.514,Houston,380236,143244,523480,38,10,48
152,8,6/16/44,8/7/44,892766,883896,63083,18230.987,1857975.987,1776662,81313.987,Houston,381359,143624,524983,39,13,52
153,6,6/20/44,8/10/44,892923,883896,63089,18232.721,1858140.721,1776819,81321.721,Houston,382366,143955,526321,38,13,51
154,9,6/24/44,8/15/44,895540,883896,63182,18259.598,1860877.598,1779436,81441.598,Houston,383733,144371,528104,39,13,52
155,5,6/28/44,8/17/44,898311,883896,63280,18287.92,1863774.92,1782207,81567.92,Houston,385725,145043,530768,38,12,50
156,4,7/1/44,8/22/44,901876,883896,63407,18324.623,1867503.623,1785772,81731.623,Houston,387475,145562,533037,40,12,52
157,3,7/8/44,8/26/44,906452,883896,63569,18371.441,1872288.441,1790348,81940.441,Houston,389400,146122,535522,39,10,49
158,2,7/13/44,8/30/44,906349,883896,63566,18370.574,1872181.574,1790245,81936.574,Houston,390784,146554,537338,37,11,48
159,7,7/18/44,9/6/44,905154,883896,63523,18358.147,1870931.147,1789050,81881.147,Houston,390597,146479,537076,38,12,50
160,1,7/22/44,9/9/44,905112,883896,63522,18357.858,1870887.858,1789008,81879.858,Houston,389824,146246,536070,38,11,49
161,8,7/26/44,9/16/44,904190,883896,53489,15458.321,1857033.321,1788086,68947.321,Houston,389017,145997,535014,38,14,52
162,6,7/29/44,9/21/44,900630,883896,63363,18311.907,1866200.907,1784526,81674.907,Houston,388043,145779,533822,38,16,54
163,9,8/3/44,9/23/44,897281,883896,63244,18277.516,1862698.516,1781177,81521.516,Houston,385067,144924,529991,37,14,51
164,5,8/5/44,9/26/44,894863,883896,63158,18252.662,1860169.662,1778759,81410.662,Houston,383992,144620,528612,40,12,52
165,4,8/11/44,9/30/44,891965,883896,63055,18222.895,1857138.895,1775861,81277.895,Houston,381530,143925,525455,40,10,50
166,3,8/17/44,10/4/44,889811,883896,62978,18200.642,1854885.642,1773707,81178.642,Houston,379243,143219,522462,37,11,48
167,2,8/21/44,10/9/44,882534,883896,62720,18126.08,1847276.08,1766430,80846.08,Houston,376519,142378,518897,39,10,49
168,7,8/26/44,10/12/44,875892,883896,62484,18057.876,1840329.876,1759788,80541.876,Houston,371927,140979,512906,37,10,47
169,1,8/30/44,10/16/44,871884,883896,62342,18016.838,1836138.838,1755780,80358.838,Houston,369237,140076,509313,37,10,47
170,8,9/2/44,10/20/44,867998,883896,62204,17976.956,1832074.956,1751894,80180.956,Houston,366722,139196,505918,39,9,48
171,6,9/5/44,10/24/44,862575,883896,62011,17921.179,1826403.179,1746471,79932.179,Houston,364818,138552,503370,42,7,49
172,9,9/9/44,10/27/44,860242,883896,61928,17897.192,1823963.192,1744138,79825.192,Houston,363177,137963,501140,38,10,48
173,5,9/15/44,10/31/44,858724,883896,61875,17881.875,1822376.875,1742620,79756.875,Houston,362999,137904,500903,35,11,46
174,4,9/20/44,11/4/44,855572,883896,61763,17849.507,1819080.507,1739468,79612.507,Houston,360360,137160,497520,34,11,45
175,3,9/23/44,11/9/44,853898,883896,61703,17832.167,1817329.167,1737794,79535.167,Houston,358619,136619,495238,35,12,47
176,2,9/29/44,11/13/44,851760,883896,61627,17810.203,1815093.203,1735656,79437.203,Houston,358204,136669,494873,34,11,45
177,7,10/3/44,11/17/44,853729,883895,61697,17830.433,1817151.433,1737624,79527.433,Houston,358054,136813,494867,36,9,45
178,1,10/7/44,11/21/44,853661,883895,61695,17829.855,1817080.855,1737556,79524.855,Houston,357228,136800,494028,37,8,45
179,8,10/11/44,11/25/44,855818,883895,61771,17851.819,1819335.819,1739713,79622.819,Houston,357505,137055,494560,36,9,45
180,6,10/14/44,11/28/44,854653,883895,61730,17839.97,1818117.97,1738548,79569.97,Houston,357595,137137,494732,35,10,45
181,9,10/18/44,11/30/44,856746,883895,61804,17861.356,1820306.356,1740641,79665.356,Houston,357781,137305,495086,35,8,43
182,5,10/20/44,12/6/44,851773,883895,61628,17810.492,1815106.492,1735668,79438.492,Houston,356221,136746,492967,35,12,47
183,4,10/25/44,12/11/44,851352,883895,61613,17806.157,1814666.157,1735247,79419.157,Houston,355578,136592,492170,35,12,47
184,3,10/30/44,12/14/44,852144,883895,61641,17814.249,1815494.249,1736039,79455.249,Houston,354818,136364,491182,35,10,45
185,2,11/3/44,12/16/44,847912,883895,61491,17770.899,1811068.899,1731807,79261.899,Houston,353398,135795,489193,34,9,43
186,7,11/8/44,12/22/44,843276,883895,61326,17723.214,1806220.214,1727171,79049.214,Houston,351571,135074,486645,36,8,44
187,1,11/13/44,12/23/44,843447,883895,61332,17724.948,1806398.948,1727342,79056.948,Houston,350775,134730,485505,32,8,40
188,8,11/17/44,12/30/44,841017,883895,61246,17700.094,1803858.094,1724912,78946.094,Houston,349896,134349,484245,33,10,43
189,6,11/18/44,12/31/44,839512,883895,61192,17684.488,1802283.488,1723407,78876.488,Houston,349591,134216,483807,34,9,43
190,9,11/22/44,1/10/45,836380,883895,61082,17652.698,1799009.698,1720275,78734.698,Houston,348090,134003,482093,38,11,49
191,5,11/25/44,1/13/45,834924,883895,61029,17637.381,1797485.381,1718819,78666.381,Houston,347036,133880,480916,39,10,49
192,4,11/29/44,1/17/45,834340,883895,61008,17631.312,1796874.312,1718235,78639.312,Houston,345666,133620,479286,38,11,49
193,3,12/4/44,1/20/45,835629,883896,61055,17644.895,1798224.895,1719525,78699.895,Houston,344099,133411,477510,37,10,47
194,2,12/7/44,1/23/45,833717,883896,60987,17625.243,1796225.243,1717613,78612.243,Houston,343573,133503,477076,37,10,47
195,7,12/15/44,1/27/45,834260,883896,61006,17630.734,1796792.734,1718156,78636.734,Houston,342815,133530,476345,34,9,43
196,1,12/15/44,1/31/45,835070,883896,61035,17639.115,1797640.115,1718966,78674.115,Houston,342707,133532,476239,35,12,47
197,8,12/20/44,2/5/45,833045,883896,60963,17618.307,1795522.307,1716941,78581.307,Houston,341654,133076,474730,36,11,47
198,6,12/23/44,2/9/45,827685,883896,60772,17563.108,1789916.108,1711581,78335.108,Houston,340427,132444,472871,39,9,48
199,9,12/30/44,2/13/45,823542,883880,60625,17520.625,1785567.625,1707422,78145.625,Houston,339419,131590,471009,34,11,45
200,5,1/4/45,2/16/45,819002,883880,60464,17474.096,1780820.096,1702882,77938.096,Houston,338703,130887,469590,31,12,43
201,4,1/6/45,2/21/45,814252,883880,60295,17425.255,1775852.255,1698132,77720.255,Houston,337902,129919,467821,34,12,46
202,3,1/11/45,2/24/45,811205,883880,60187,17394.043,1772666.043,1695085,77581.043,Houston,336781,128971,465752,33,11,44
203,2,1/13/45,2/28/45,806190,883880,60009,17342.601,1767421.601,1690070,77351.601,Houston,336391,128479,464870,35,11,46
204,7,1/19/45,3/7/45,809709,883880,60134,17378.726,1771101.726,1693589,77512.726,Houston,340070,129292,469362,35,12,47
205,1,1/20/45,3/9/45,812627,883880,60237,17408.493,1774152.493,1696507,77645.493,Houston,341142,129539,470681,35,13,48
206,8,1/25/45,3/17/45,825065,883880,60679,17536.231,1787160.231,1708945,78215.231,Houston,348600,131652,480252,41,10,51
207,6,1/31/45,3/24/45,825517,883880,60695,17540.855,1787632.855,1709397,78235.855,Houston,352665,132587,485252,40,12,52
208,9,2/2/45,3/28/45,836346,883880,61079,17651.831,1798956.831,1720226,78730.831,Houston,358041,134363,492404,41,13,54
1,7,2/15/41,12/31/41,1919943,888165,99706,28815.034,2936629.034,2808108,128521.034,Oregon,855176,349594,1204770,275,44,319
2,6,3/13/41,2/3/42,1688815,888165,91500,26443.5,2694923.5,2576980,117943.5,Oregon,740304,284417,1024721,278,49,327
3,5,3/16/41,2/11/42,1612460,888165,88789,25660.021,2615074.021,2500625,114449.021,Oregon,702355,262500,964855,291,41,332
4,8,3/20/41,1/27/42,1727157,888165,92861,26836.829,2735019.829,2615322,119697.829,Oregon,759426,298797,1058223,254,59,313
5,3,6/3/41,2/24/42,1518397,888165,85449,24694.761,2516705.761,2406562,110143.761,Oregon,655603,230246,885849,218,48,266
6,4,6/12/41,2/17/42,1573510,888165,87406,25260.334,2574341.334,2461675,112666.334,Oregon,682995,248009,931004,211,39,250
7,7,9/7/41,5/28/42,1095938,888165,70449,20359.761,2074911.761,1984103,90808.761,Oregon,445634,140329,585963,211,52,263
8,2,10/28/41,2/28/42,1466651,888165,83612,24163.868,2462591.868,2354816,107775.868,Oregon,629588,215272,844860,91,32,123
9,5,11/7/41,6/5/42,1118513,888165,71250,20591.25,2098519.25,2006678,91841.25,Oregon,456853,146300,603153,171,39,210
10,6,11/8/41,5/31/42,1093288,888165,70355,20332.595,2072140.595,1981453,90687.595,Oregon,444318,141184,585502,164,40,204
11,1,11/18/41,3/7/42,1431573,888165,82366,23803.774,2425907.774,2319738,106169.774,Oregon,612451,206288,818739,78,31,109
12,7,12/11/41,3/28/42,1382123,888165,80610,23296.29,2374194.29,2270288,103906.29,Oregon,587872,183800,771672,82,25,107
13,11,12/11/41,3/10/42,1384406,888165,80691,23319.699,2376581.699,2272571,104010.699,Oregon,589007,190067,779074,69,20,89
14,8,12/14/41,3/24/42,1367734,888165,80099,23148.611,2359146.611,2255899,103247.611,Oregon,580721,181430,762151,76,24,100
15,10,12/21/41,3/15/42,1423953,888165,82096,23725.744,2417939.744,2312118,105821.744,Oregon,608663,194610,803273,69,15,84
16,6,12/25/41,4/1/42,1324675,888165,78571,22707.019,2314118.019,2212840,101278.019,Oregon,559320,173237,732557,78,19,97
17,5,12/27/41,4/4/42,1337040,888165,79010,22833.89,2327048.89,2225205,101843.89,Oregon,565465,173548,739013,74,24,98
18,9,12/29/41,3/20/42,1474609,888165,83894,24245.366,2470913.366,2362774,108139.366,Oregon,633840,201939,835779,69,12,81
19,4,1/10/42,4/8/42,1342255,888165,79195,22887.355,2332502.355,2230420,102082.355,Oregon,568058,174005,742063,69,19,88
20,3,1/14/42,4/11/42,1267331,888165,76534,22118.326,2254148.326,2155496,98652.326,Oregon,530819,162345,693164,67,20,87
21,2,1/20/42,4/15/42,1233116,888165,75320,21767.48,2218368.48,2121281,97087.48,Oregon,513815,157140,670955,57,28,85
22,1,1/22/42,4/18/42,1247816,888165,75842,21918.338,2233741.338,2135981,97760.338,Oregon,521120,159562,680682,64,22,86
23,7,2/3/42,5/2/42,1195376,888165,73980,21380.22,2178901.22,2083541,95360.22,Oregon,495057,152324,647381,68,20,88
24,8,2/8/42,4/28/42,1172364,888165,73162,21143.818,2154834.818,2060529,94305.818,Oregon,483619,148945,632564,63,16,79
25,11,2/10/42,4/21/42,1268564,888165,76578,22131.042,2255438.042,2156729,98709.042,Oregon,531431,162882,694313,54,16,70
26,10,2/14/42,4/24/42,1256900,888165,76164,22011.396,2243240.396,2145065,98175.396,Oregon,525634,161202,686836,55,14,69
27,9,2/14/42,4/27/42,1279526,888165,76967,22243.463,2266901.463,2167691,99210.463,Oregon,536879,160490,697369,56,16,72
28,6,2/17/42,5/4/42,1171404,888165,73128,21133.992,2153830.992,2059569,94261.992,Oregon,483142,148791,631933,62,14,76
29,5,2/19/42,5/7/42,1160912,888165,72756,21026.484,2142859.484,2049077,93782.484,Oregon,477927,147206,625133,59,18,77
30,4,2/23/42,5/9/42,1163238,888165,72838,21050.182,2145291.182,2051403,93888.182,Oregon,479084,147427,626511,58,17,75
31,3,2/23/42,5/13/42,1140541,888165,72033,20817.537,2121556.537,2028706,92850.537,Oregon,467802,143954,611756,61,18,79
32,3,2/24/42,6/1/42,1107000,888165,70856,20477.384,980605.384,1995165,91333.384,Oregon,451335,145643,596978,76,21,97
33,4,3/1/42,6/8/42,1110798,888165,70976,20512.064,2090451.064,1998963,91488.064,Oregon,453020,146062,599082,78,21,99
34,2,3/3/42,5/15/42,1136860,888165,71902,20779.678,2117706.678,2025025,92681.678,Oregon,465972,143652,609624,60,13,73
35,1,3/5/42,5/17/42,1142325,888165,72096,20835.744,2123421.744,2030490,92931.744,Oregon,468688,144623,613311,58,15,73
36,2,3/11/42,6/12/42,1167432,888165,72987,21093.243,2149677.243,2055597,94080.243,Oregon,481167,158011,639178,76,17,93
37,10,3/12/42,5/22/42,1093947,888165,70378,20339.242,2072829.242,1982112,90717.242,Oregon,444645,137896,582541,56,15,71
38,11,3/14/42,5/22/42,1106665,888165,70830,20469.87,2086129.87,1994830,91299.87,Oregon,450964,143644,594608,59,10,69
39,9,3/15/42,5/22/42,1136634,888165,71894,20777.366,2117470.366,2024799,92671.366,Oregon,465860,145095,610955,53,15,68
40,8,3/26/42,5/25/42,1108784,888165,70906,20491.834,2088346.834,1996949,91397.834,Oregon,452019,141754,593773,50,10,60
41,1,4/9/42,6/16/42,1167347,888165,72984,21092.376,2149588.376,2055512,94076.376,Oregon,481125,159542,640667,53,15,68
42,11,4/13/42,6/20/42,1222587,888165,74946,21659.394,2207357.394,2110752,96605.394,Oregon,508581,171318,679899,55,13,68
43,10,4/26/42,6/24/42,1299478,888165,77676,22448.364,2287767.364,2187643,100124.364,Oregon,546802,187269,734071,50,9,59
44,9,4/26/42,6/28/42,1303275,888165,77813,22487.957,2291740.957,2191440,100300.957,Oregon,528162,187599,715761,48,15,63
45,8,4/28/42,6/30/42,1238035,888165,75494,21817.766,2223511.766,2126200,97311.766,Oregon,497625,177841,675466,51,12,63
46,7,5/2/42,7/6/42,1215437,888165,74692,21585.988,2199879.988,2103602,96277.988,Oregon,487078,176472,663550,51,14,65
47,6,5/11/42,7/9/42,1193313,888165,73906,21358.834,2176742.834,2081478,95264.834,Oregon,476753,174107,650860,43,16,59
48,5,5/14/42,7/14/42,1169891,888165,73075,21118.675,2152249.675,2058056,94193.675,Oregon,465820,171672,637492,46,15,61
49,4,5/17/42,7/17/42,1184443,888165,73591,21267.799,2167466.799,2072608,94858.799,Oregon,472612,175084,647696,41,20,61
50,3,5/17/42,7/20/42,1141136,888165,72054,20823.606,2122178.606,2029301,92877.606,Oregon,452399,168099,620498,46,18,64
51,2,5/24/42,7/25/42,1146002,888165,72226,20873.314,2127266.314,2034167,93099.314,Oregon,454670,169161,623831,43,19,62
52,1,5/26/42,7/27/42,1114238,888165,71099,20547.611,2094049.611,2002403,91646.611,Oregon,439845,164323,604168,44,18,62
53,11,6/1/42,7/30/42,1116148,888165,71166,20566.974,2096045.974,2004313,91732.974,Oregon,440737,165634,606371,44,15,59
54,10,6/1/42,7/31/42,1109030,888165,70914,20494.146,2088603.146,1997195,91408.146,Oregon,437414,164846,602260,44,16,60
55,9,6/3/42,8/5/42,1089105,888165,70206,20289.534,2067765.534,1977270,90495.534,Oregon,428115,161254,589369,42,21,63
56,8,6/7/42,8/11/42,1119341,888165,71280,20599.92,2099385.92,2007506,91879.92,Oregon,442228,166655,608883,46,19,65
57,7,6/13/42,8/13/42,1134907,888165,71832,20759.448,2115663.448,2023072,92591.448,Oregon,449491,169606,619097,44,17,61
58,6,6/16/42,8/17/42,1117834,888165,71226,20584.314,2097809.314,2005999,91810.314,Oregon,441522,166900,608422,45,17,62
59,5,6/23/42,8/20/42,1088289,888165,70177,20281.153,2066912.153,1976454,90458.153,Oregon,427735,162102,589837,43,15,58
60,4,6/25/42,8/23/42,1087070,888165,70134,20268.726,2065637.726,1975235,90402.726,Oregon,427164,162262,589426,43,16,59
61,3,7/2/42,8/26/42,1070879,888165,69559,20102.551,2048705.551,1959044,89661.551,Oregon,419609,159683,579292,41,14,55
62,2,7/3/42,8/29/42,1064215,888165,69322,20034.058,2041736.058,1952380,89356.058,Oregon,416497,158792,575289,42,15,57
63,1,7/5/42,8/31/42,1039391,888165,68443,19780.027,2015779.027,1927556,88223.027,Oregon,404911,154656,559567,42,15,57
64,11,7/13/42,9/7/42,1055214,888165,69003,19941.867,2032323.867,1943379,88944.867,Oregon,412297,158081,570378,40,16,56
65,10,7/13/42,9/9/42,1007417,888165,67306,19451.434,1982339.434,1895582,86757.434,Oregon,389987,150153,540140,40,18,58
66,7,7/15/42,9/1/42,974711,888165,66144,19115.616,1948135.616,1862876,85259.616,Oregon,374725,144625,519350,37,11,48
67,9,7/19/42,9/12/42,1015621,888165,67597,19535.533,1990918.533,1903786,87132.533,Oregon,393819,152217,546036,38,17,55
68,8,7/22/42,9/15/42,1030496,888165,68125,19688.125,2006474.125,1918661,87813.125,Oregon,400760,155606,556366,41,14,55
69,6,7/24/42,9/18/42,1001984,888165,67113,19395.657,1976657.657,1890149,86508.657,Oregon,387452,151335,538787,40,16,56
70,5,7/25/42,9/26/42,843941,888165,61501,17773.789,1811380.789,1732106,79274.789,Oregon,313689,129151,442840,44,19,63
71,5,7/26/42,9/21/42,976324,888165,66202,19132.378,1949823.378,1864489,85334.378,Oregon,375476,147142,522618,43,14,57
72,3,7/31/42,9/25/42,957841,888165,65545,18942.505,1930493.505,1846006,84487.505,Oregon,366851,145401,512252,39,17,56
73,4,8/1/42,9/23/42,963287,888165,65739,18998.571,1936189.571,1851452,84737.571,Oregon,369393,145530,514923,41,12,53
74,1,8/2/42,10/3/42,957123,888165,65520,18935.28,1929743.28,1845288,84455.28,Oregon,366514,146792,513306,41,21,62
75,2,8/4/42,9/30/42,960857,888165,65653,18973.717,1933648.717,1849022,84626.717,Oregon,368257,146764,515021,42,15,57
76,11,8/7/42,10/5/42,920987,888165,64237,18564.493,1891953.493,1809152,82801.493,Oregon,349648,140925,490573,38,21,59
77,10,8/11/42,10/8/42,959764,888165,65614,18962.446,1932505.446,1847929,84576.446,Oregon,367748,148755,516503,40,18,58
78,9,8/12/42,10/11/42,963306,888165,65740,18998.86,1936209.86,1851471,84738.86,Oregon,369400,150212,519612,46,14,60
79,8,8/14/42,10/13/42,920441,888165,64218,18559.002,1891383.002,1808606,82777.002,Oregon,349394,142429,491823,46,14,60
80,7,8/19/42,10/16/42,938805,888165,64870,18747.43,1910587.43,1826970,83617.43,Oregon,357966,146294,504260,44,14,58
81,2,8/20/42,10/27/42,893167,888165,63249,18278.961,1862859.961,1781332,81527.961,Oregon,336664,139458,476122,49,19,68
82,6,8/23/42,10/18/42,946055,888165,65127,18821.703,1918168.703,1834220,83948.703,Oregon,361349,148141,509490,44,12,56
83,4,8/23/42,10/21/42,1030733,888165,68134,19690.726,2006722.726,1918898,87824.726,Oregon,400870,164669,565539,45,14,59
84,3,8/23/42,10/24/42,936026,888165,64771,18718.819,1907680.819,1824191,83489.819,Oregon,356667,147388,504055,46,16,62
85,1,8/25/42,10/29/42,873275,888165,62543,18074.927,1842057.927,1761440,80617.927,Oregon,327380,135959,463339,48,17,65
86,11,8/30/42,10/31/42,887426,888165,63045,18220.005,1856856.005,1775591,81265.005,Oregon,333985,138837,472822,48,14,62
87,5,9/3/42,11/2/42,837956,888165,61289,17712.521,1805122.521,1726121,79001.521,Oregon,310894,129102,439996,48,12,60
88,10,9/6/42,11/5/42,858407,888165,62015,17922.335,1826509.335,1746572,79937.335,Oregon,320441,132983,453424,49,11,60
89,9,9/8/42,11/7/42,836125,888165,61224,17693.736,1803207.736,1724290,78917.736,Oregon,310043,128595,438638,47,13,60
90,8,9/8/42,11/10/42,852619,888165,61809,17862.801,1820455.801,1740784,79671.801,Oregon,317739,131646,449385,49,14,63
91,7,9/11/42,11/12/42,849775,888165,61708,17833.612,1817481.612,1737940,79541.612,Oregon,316411,130957,447368,49,13,62
92,6,9/17/42,11/15/42,857946,888165,61999,17917.711,1826027.711,1746111,79916.711,Oregon,320225,132209,452434,48,11,59
93,4,9/20/42,11/19/42,852382,888165,61801,17860.489,1820208.489,1740547,79661.489,Oregon,317629,130779,448408,46,14,60
94,5,9/20/42,11/17/42,803933,888165,60081,17363.409,1769542.409,1692098,77444.409,Oregon,295015,121359,416374,44,14,58
95,3,9/29/42,11/21/42,829014,888165,60971,17620.619,1795770.619,1717179,78591.619,Oregon,306722,125943,432665,42,11,53
96,2,10/3/42,11/24/42,829198,888165,60978,17622.642,1795963.642,1717363,78600.642,Oregon,306808,125644,432452,42,10,52
97,1,10/6/42,11/26/42,815667,888165,60497,17483.633,1781812.633,1703832,77980.633,Oregon,300492,122751,423243,39,12,51
98,11,10/8/42,11/28/42,815818,888165,60503,17485.367,1781971.367,1703983,77988.367,Oregon,300564,122358,422922,42,9,51
99,9,10/10/42,12/2/42,819940,888165,60649,17527.561,1786281.561,1708105,78176.561,Oregon,302488,122309,424797,41,12,53
100,10,10/12/42,11/30/42,812348,888165,60380,17449.82,1778342.82,1700513,77829.82,Oregon,298945,121317,420262,39,10,49
101,8,10/14/42,12/5/42,840984,888165,61396,17743.444,1808288.444,1729149,79139.444,Oregon,312309,125835,438144,41,11,52
102,7,10/15/42,12/7/42,838100,888165,61294,17713.966,1805272.966,1726265,79007.966,Oregon,310962,124908,435870,43,10,53
103,10,10/15/42,12/23/42,797296,888165,59845,17295.205,1762601.205,1685461,77140.205,Oregon,291917,116075,407992,57,12,69
104,6,10/16/42,12/9/42,829929,888165,61004,17630.156,1796728.156,1718094,78634.156,Oregon,307149,123143,430292,44,10,54
105,2,10/17/42,12/17/42,801984,888165,60008,17342.312,1767499.312,1690149,77350.312,Oregon,294106,117227,411333,47,14,61
106,1,10/19/42,12/19/42,805737,888165,60145,17381.905,1771428.905,1693902,77526.905,Oregon,295858,117759,413617,47,14,61
107,11,10/19/42,12/21/42,801892,888165,60008,17342.312,1767407.312,1690057,77350.312,Oregon,294063,116899,410962,52,11,63
108,5,10/21/42,12/11/42,817346,888165,60557,17500.973,1783568.973,1705511,78057.973,Oregon,301275,120481,421756,39,12,51
109,4,10/24/42,12/13/42,828118,888165,60939,17611.371,1794833.371,1716283,78550.371,Oregon,306304,122424,428728,37,13,50
110,3,10/29/42,12/15/42,814686,888165,60463,17473.807,1780787.807,1702851,77936.807,Oregon,300036,119762,419798,37,10,47
111,7,10/29/42,12/29/42,804776,888165,60111,17372.079,1770424.079,1692941,77483.079,Oregon,295410,117491,412901,51,10,61
112,6,10/29/42,12/31/42,796585,888165,59820,17287.98,1761857.98,1684750,77107.98,Oregon,291585,115883,407468,51,12,63
113,9,10/30/42,12/25/42,811551,888165,60351,17441.439,1777508.439,1699716,77792.439,Oregon,298573,118758,417331,43,13,56
114,5,10/31/42,1/3/43,790329,888165,59598,17223.822,1755315.822,1678494,76821.822,Oregon,288668,114777,403445,52,12,64
115,4,11/1/42,1/5/43,780551,888165,59250,17123.25,1745089.25,1668716,76373.25,Oregon,284103,113011,397114,53,12,65
116,3,11/1/42,1/7/43,791534,888165,59640,17235.96,1756574.96,1679699,76875.96,Oregon,289231,114984,404215,55,12,67
117,8,11/8/42,12/27/42,804144,888165,60008,17342.312,1769659.312,1692309,77350.312,Oregon,295116,117414,412530,37,12,49
118,2,11/9/42,1/9/43,783369,888165,59351,17152.439,1748037.439,1671534,76503.439,Oregon,285420,113503,398923,47,14,61
119,1,11/14/42,1/12/43,783521,888165,59356,17153.884,1748195.884,1671686,76509.884,Oregon,285488,113620,399108,44,15,59
120,11,11/20/42,1/14/43,780498,888165,59249,17122.961,1745034.961,1668663,76371.961,Oregon,284079,113176,397255,42,13,55
121,10,11/24/42,1/16/43,771010,888165,58912,17025.568,1735112.568,1659175,75937.568,Oregon,279651,111551,391202,41,12,53
122,,11/27/42,1/11/43,1435736,888165,82514,23846.546,2430261.546,2323901,106360.546,Oregon,530961,250852,781813,34,11,45
123,9,11/29/42,1/18/43,749538,888165,58149,16805.061,1712657.061,1637703,74954.061,Oregon,269630,107783,377413,39,11,50
124,8,12/2/42,1/22/43,766500,888165,58752,16979.328,1730396.328,1654665,75731.328,Oregon,277546,113204,390750,37,14,51
125,,12/4/42,1/20/43,1430254,888165,82319,23790.191,2424528.191,2318419,106109.191,Oregon,525891,250462,776353,35,12,47
126,7,12/6/42,1/24/43,758084,888165,58453,16892.917,1721594.917,1646249,75345.917,Oregon,273616,112934,386550,38,11,49
127,6,12/9/42,1/27/43,755925,888165,58376,16870.664,1719336.664,1644090,75246.664,Oregon,272608,112964,385572,36,13,49
128,5,12/11/42,1/31/43,785746,888165,59435,17176.715,1750522.715,1673911,76611.715,Oregon,286527,119221,405748,40,11,51
129,,12/15/42,1/29/43,1439162,888165,82636,23881.804,2433844.804,2327327,106517.804,Oregon,534103,256106,790209,34,11,45
130,4,12/16/42,2/2/43,762496,888165,58609,16938.001,1726208.001,1650661,75547.001,Oregon,275676,115941,391617,36,12,48
131,3,12/17/42,2/6/43,775534,888165,59072,17071.808,1739842.808,1663699,76143.808,Oregon,281761,117702,399463,39,12,51
132,2,12/21/42,2/8/43,772511,888165,58965,17040.885,1736681.885,1660676,76005.885,Oregon,280350,116691,397041,39,10,49
133,,12/21/42,2/4/43,1437084,888165,82562,23860.418,2431671.418,2325249,106422.418,Oregon,532191,254418,786609,36,9,45
134,1,12/23/42,2/12/43,765088,888165,58701,16964.589,1728918.589,1653253,75665.589,Oregon,276543,115060,391603,41,10,51
135,11,12/24/42,2/14/43,775054,888165,59055,17066.895,1739340.895,1663219,76121.895,Oregon,281590,117201,398791,39,13,52
136,10,12/25/42,2/16/43,782836,888165,59332,17146.948,1747479.948,1671001,76478.948,Oregon,293912,122389,416301,41,12,53
137,9,12/27/42,2/17/43,762557,888165,58612,16938.868,1726272.868,1650722,75550.868,Oregon,284702,118818,403520,41,11,52
138,,12/27/42,2/10/43,1440029,888165,82666,23890.474,2434750.474,2328194,106556.474,Oregon,534972,253856,788828,37,8,45
139,8,12/28/42,2/19/43,759299,888165,58496,16905.344,1722865.344,1647464,75401.344,Oregon,283223,118057,401280,41,12,53
140,7,1/3/43,2/23/43,784702,888165,59398,17166.022,1749431.022,1672867,76564.022,Oregon,294760,122669,417429,40,11,51
141,6,1/5/43,2/26/43,774288,888165,59028,17059.092,1738540.092,1662453,76087.092,Oregon,290031,120262,410293,39,13,52
142,,1/7/43,2/21/43,1439934,888165,82663,23889.607,2434651.607,2328099,106552.607,Oregon,534848,252742,787590,36,9,45
143,,1/10/43,2/24/43,1434354,888165,82465,23832.385,2428816.385,2322519,106297.385,Oregon,529682,250755,780437,35,10,45
144,4,1/11/43,3/1/43,755444,888165,58359,16865.751,1718833.751,1643609,75224.751,Oregon,281472,115952,397424,37,12,49
145,5,1/12/43,2/28/43,763733,888165,58653,16950.717,1727501.717,1651898,75603.717,Oregon,285237,117833,403070,38,9,47
146,3,1/16/43,3/4/43,758149,888165,58455,16893.495,1721662.495,1646314,75348.495,Oregon,282700,115961,398661,35,12,47
147,2,1/18/43,3/6/43,739125,888165,57780,16698.42,1701768.42,1627290,74478.42,Oregon,274061,111905,385966,36,11,47
148,,1/19/43,3/3/43,1439706,888165,82655,23887.295,2434413.295,2327871,106542.295,Oregon,534632,252682,787314,35,8,43
149,1,1/23/43,3/8/43,773718,888165,59008,17053.312,1737944.312,1661883,76061.312,Oregon,289772,117987,407759,33,11,44
150,11,1/26/43,3/10/43,750716,888165,58191,16817.199,1713889.199,1638881,75008.199,Oregon,279325,113217,392542,34,9,43
151,10,1/26/43,3/12/43,744490,888165,57970,16753.33,1707378.33,1632655,74723.33,Oregon,276498,111629,388127,34,11,45
152,9,1/28/43,3/13/43,751553,888165,58221,16825.869,1714764.869,1639718,75046.869,Oregon,279706,112866,392572,34,10,44
153,7,1/30/43,3/17/43,746430,888165,58039,16773.271,1709407.271,1634595,74812.271,Oregon,277378,111750,389128,35,11,46
154,8,1/31/43,3/15/43,733391,888165,57576,16639.464,1695771.464,1621556,74215.464,Oregon,271458,109393,380851,36,7,43
155,6,2/1/43,3/19/43,737830,888165,57734,16685.126,1700414.126,1625995,74419.126,Oregon,273472,110247,383719,34,12,46
156,5,2/1/43,3/21/43,728360,888165,57397,16587.733,1690509.733,1616525,73984.733,Oregon,269172,108416,377588,37,11,48
157,4,2/1/43,3/22/43,737947,888165,57738,16686.282,1700536.282,1626112,74424.282,Oregon,273526,110154,383680,37,12,49
158,3,2/1/43,3/24/43,749202,888165,58137,16801.593,1712305.593,1637367,74938.593,Oregon,278637,112145,390782,40,11,51
159,1,2/3/43,3/27/43,727438,888165,57365,16578.485,1689546.485,1615603,73943.485,Oregon,268753,108143,376896,39,13,52
160,2,2/5/43,3/25/43,729087,888165,57423,16595.247,1691270.247,1617252,74018.247,Oregon,269502,108467,377969,38,10,48
161,11,2/5/43,3/28/43,734425,888165,57613,16650.157,1696853.157,1622590,74263.157,Oregon,271927,109352,381279,38,13,51
162,10,2/6/43,3/30/43,710320,888165,56757,16402.773,1671644.773,1598485,73159.773,Oregon,260980,104987,365967,39,13,52
163,9,2/9/43,3/31/43,710836,888165,56775,16407.975,1672183.975,1599001,73182.975,Oregon,261214,105130,366344,38,12,50
164,8,2/9/43,4/2/43,703329,888165,56509,16331.101,1664334.101,1591494,72840.101,Oregon,257804,103901,361705,40,12,52
165,7,2/14/43,4/4/43,706831,888165,56633,16366.937,1667995.937,1594996,72999.937,Oregon,259394,104652,364046,39,10,49
166,6,2/17/43,4/6/43,712009,888165,56817,16420.113,1673411.113,1600174,73237.113,Oregon,261746,105628,367374,37,11,48
167,5,2/17/43,4/8/43,710377,888165,56759,16403.351,1671704.351,1598542,73162.351,Oregon,261006,105350,366356,38,12,50
168,3,2/18/43,4/11/43,710923,888165,56778,16408.842,1672274.842,1599088,73186.842,Oregon,261253,105533,366786,38,14,52
169,2,2/18/43,4/13/43,727396,888165,57363,16577.907,1689501.907,1615561,73940.907,Oregon,268734,108592,377326,38,16,54
170,4,2/19/43,4/9/43,702126,888165,56466,16318.674,1663075.674,1590291,72784.674,Oregon,257257,103895,361152,38,11,49
171,1,2/23/43,4/15/43,729264,888165,57429,16596.981,1691454.981,1617429,74025.981,Oregon,269583,108907,378490,37,14,51
172,11,2/24/43,4/17/43,719130,888165,57070,16493.23,1680858.23,1607295,73563.23,Oregon,264980,107035,372015,40,12,52
173,10,2/28/43,4/19/43,717110,888165,56998,16472.422,1678745.422,1605275,73470.422,Oregon,264062,106689,370751,40,10,50
174,9,3/4/43,4/21/43,698908,888165,56352,16285.728,1659710.728,1587073,72637.728,Oregon,255796,103348,359144,37,11,48
175,8,3/4/43,4/22/43,691461,888165,56087,16209.143,1651922.143,1579626,72296.143,Oregon,252414,102059,354473,39,10,49
176,7,3/8/43,4/24/43,711563,888165,56801,16415.489,1672944.489,1599728,73216.489,Oregon,261544,105802,367346,37,10,47
177,6,3/10/43,4/26/43,692962,888165,56141,16224.749,1653492.749,1581127,72365.749,Oregon,253096,102400,355496,37,10,47
178,5,3/10/43,4/27/43,698569,888165,56340,16282.26,1659356.26,1586734,72622.26,Oregon,255642,103463,359105,39,9,48
179,4,3/11/43,4/29/43,683600,888165,55808,16128.512,1643701.512,1571765,71936.512,Oregon,248844,100776,349620,42,7,49
180,3,3/13/43,4/30/43,669987,888165,55325,15988.925,1629465.925,1558152,71313.925,Oregon,241666,97966,339632,38,10,48
181,2,3/18/43,5/3/43,675824,888165,55532,16048.748,1635569.748,1563989,71580.748,Oregon,245351,99479,344830,35,11,46
182,,3/19/43,5/5/43,686105,888165,55897,16154.233,1646321.233,1574270,72051.233,Oregon,249383,102878,352261,35,12,47
183,,3/20/43,5/6/43,692109,888165,56110,16215.79,1652599.79,1580274,72325.79,Oregon,251336,103737,355073,35,12,47
184,,3/24/43,5/8/43,693734,888165,56168,16232.552,1654299.552,1581899,72400.552,Oregon,255307,105497,360804,35,10,45
185,,3/28/43,5/10/43,675682,888165,55527,16047.303,1635421.303,1563847,71574.303,Oregon,245998,101768,347766,34,9,43
186,,3/29/43,5/12/43,678645,888165,55630,16077.07,1638517.07,1566810,71707.07,Oregon,246047,101916,347963,36,8,44
187,,3/30/43,5/18/43,677362,888165,55587,16064.643,1637178.643,1565527,71651.643,Oregon,243959,101804,345763,38,11,49
188,,4/1/43,5/20/43,679437,888165,55660,16085.74,1639347.74,1567602,71745.74,Oregon,245945,102901,348846,39,10,49
189,,4/2/43,5/15/43,671719,888165,55386,16006.554,1631276.554,1559884,71392.554,Oregon,244799,101835,346634,33,10,43
190,,4/3/43,5/13/43,686659,888165,55917,16160.013,1646901.013,1574824,72077.013,Oregon,248886,103319,352205,32,8,40
191,,4/3/43,5/22/43,673178,888165,55438,16021.582,1632802.582,1561343,71459.582,Oregon,244461,102457,346918,38,11,49
192,,4/4/43,5/17/43,668694,888165,55279,15975.631,1628113.631,1556859,71254.631,Oregon,242311,100952,343263,34,9,43
193,,4/7/43,5/24/43,666040,888165,55185,15948.465,1625338.465,1554205,71133.465,Oregon,240468,100976,341444,37,10,47
194,,4/9/43,5/26/43,680638,888165,55703,16098.167,1640604.167,1568803,71801.167,Oregon,244900,103003,347903,37,10,47
195,,4/12/43,5/29/43,673786,888165,55460,16027.94,1633438.94,1561951,71487.94,Oregon,243620,102903,346523,35,12,47
196,,4/14/43,5/27/43,669895,888165,55321,15987.769,1629368.769,1558060,71308.769,Oregon,240114,101205,341319,34,9,43
197,,4/14/43,5/31/43,681912,888165,55748,16111.172,1641936.172,1570077,71859.172,Oregon,245966,104096,350062,36,11,47
198,,4/15/43,6/2/43,677447,888165,55590,16065.51,1637267.51,1565612,71655.51,Oregon,242433,102742,345175,39,9,48
199,,4/19/43,6/3/43,669783,888165,55317,15986.613,1629251.613,1557948,71303.613,Oregon,237839,100976,338815,34,11,45
200,,4/22/43,6/7/43,678459,888165,55626,16075.914,1638325.914,1566624,71701.914,Oregon,242019,103061,345080,34,12,46
201,,4/23/43,6/5/43,664193,888165,55119,15929.391,1623406.391,1552358,71048.391,Oregon,237123,100812,337935,31,12,43
202,,4/26/43,6/9/43,697554,888165,56304,16271.856,1658294.856,1585719,72575.856,Oregon,250373,106774,357147,33,11,44
203,,4/26/43,6/11/43,691954,888165,56105,16214.345,1652438.345,1580119,72319.345,Oregon,246987,105529,352516,35,11,46
204,,4/26/43,6/16/43,683327,888165,55798,16125.622,1643415.622,1571492,71923.622,Oregon,246117,105675,351792,41,10,51
205,,4/27/43,6/13/43,689899,888165,56032,16193.248,1650289.248,1578064,72225.248,Oregon,249986,107070,357056,35,12,47
206,,4/27/43,6/18/43,688061,888165,55966,16174.174,1648366.174,1576226,72140.174,Oregon,247819,106582,354401,40,12,52
207,,4/27/43,6/20/43,679119,888165,55649,16082.561,1639015.561,1567284,71731.561,Oregon,246951,106389,353340,41,13,54
208,,4/28/43,6/15/43,679966,888165,55679,16091.231,1639901.231,1568131,71770.231,Oregon,244119,104649,348768,35,13,48
209,,6/22/43,6/22/43,674798,888165,55496,16038.344,1634497.344,1562963,71534.344,Oregon,244542,105500,350042,,,
210,,6/23/43,6/23/43,675780,888165,55530,16048.17,1635523.17,1563945,71578.17,Oregon,244981,105811,350792,,,
211,,6/25/43,6/25/43,684213,888165,55830,16134.87,1644342.87,1572378,71964.87,Oregon,248239,107414,355653,,,
212,,6/27/43,6/27/43,674652,888165,55490,16036.61,1634343.61,1562817,71526.61,Oregon,246092,106651,352743,,,
213,,6/29/43,6/29/43,665385,888165,55161,15941.529,1624652.529,1553550,71102.529,Oregon,242448,105189,347637,,,
214,,6/30/43,6/30/43,676202,888165,55545,16052.505,1635964.505,1564367,71597.505,Oregon,245130,106444,351574,,,
215,,7/2/43,7/2/43,679342,888165,55657,16084.873,1639248.873,1567507,71741.873,Oregon,248455,108045,356500,,,
216,,7/4/43,7/4/43,686699,888165,55918,16160.302,1646942.302,1574864,72078.302,Oregon,253368,110224,363592,,,
217,,7/6/43,7/6/43,676883,888165,55570,16059.73,1636677.73,1565048,71629.73,Oregon,247432,107747,355179,,,
218,,7/8/43,7/8/43,695469,888165,56230,16250.47,1656114.47,1583634,72480.47,Oregon,253624,110433,364057,,,
219,,7/9/43,7/9/43,690486,888165,56053,16199.317,1650903.317,1578651,72252.317,Oregon,251820,109677,361497,,,
220,,7/11/43,7/11/43,688600,888165,55986,16179.954,1648930.954,1576765,72165.954,Oregon,250092,108908,359000,,,
221,,7/13/43,7/13/43,697068,888165,56286,16266.654,1657785.654,1585233,72552.654,Oregon,253733,110547,364280,,,
222,,7/14/43,7/14/43,702173,888165,56468,16319.252,1663125.252,1590338,72787.252,Oregon,254083,110750,364833,,,
223,,7/16/43,7/16/43,685659,888165,55881,16149.609,1645854.609,1573824,72030.609,Oregon,247791,108114,355905,,,
224,,7/18/43,7/18/43,696320,888165,56260,16259.14,1657004.14,1584485,72519.14,Oregon,253205,110587,363792,,,
225,,7/20/43,7/20/43,687112,888165,55933,16164.637,1647374.637,1575277,72097.637,Oregon,246823,107861,354684,,,
226,,7/22/43,7/22/43,705373,888165,56581,16351.909,1666470.909,1593538,72932.909,Oregon,254825,111462,366287,,,
227,,7/24/43,7/24/43,708600,888165,56696,16385.144,1669846.144,1596765,73081.144,Oregon,257523,112783,370306,,,
228,,7/25/43,7/25/43,689824,888165,56029,16192.381,1650210.381,1577989,72221.381,Oregon,249333,109259,358592,,,
229,,7/27/43,7/27/43,698302,888165,56330,16279.37,1659076.37,1586467,72609.37,Oregon,251307,110252,361559,,,
230,,7/29/43,7/29/43,709792,888165,56736,16396.704,1671089.704,1597957,73132.704,Oregon,255883,112307,368190,,,
231,,7/31/43,7/31/43,712288,888165,56827,16423.003,1673703.003,1600453,73250.003,Oregon,259326,113893,373219,,,
232,,8/2/43,8/2/43,689440,888165,56015,16188.335,1649808.335,1577605,72203.335,Oregon,248391,109154,357545,,,
233,,8/4/43,8/4/43,697365,888165,56297,16269.833,1658096.833,1585530,72566.833,Oregon,250631,110135,360766,,,
234,,8/5/43,8/5/43,694842,888165,56207,16243.823,1655457.823,1583007,72450.823,Oregon,248054,109031,357085,,,
235,,8/7/43,8/7/43,684102,888165,55826,16133.714,1644226.714,1572267,71959.714,Oregon,246811,108437,355248,,,
236,,8/9/43,8/9/43,691437,888165,56086,16208.854,1651896.854,1579602,72294.854,Oregon,248203,109047,357250,,,
237,,8/10/43,8/10/43,687516,888165,55947,16168.683,1647796.683,1575681,72115.683,Oregon,245712,107904,353616,,,
238,,8/12/43,8/12/43,709723,888165,56736,16396.704,1671020.704,1597888,73132.704,Oregon,253816,111429,365245,,,
239,,8/14/43,8/14/43,694642,888165,56200,16241.8,1655248.8,1582807,72441.8,Oregon,250010,109694,359704,,,
240,,8/16/43,8/16/43,685172,888165,55864,16144.696,1645345.696,1573337,72008.696,Oregon,244801,107368,352169,,,
241,,8/17/43,8/17/43,700530,888165,56409,16302.201,1661406.201,1588695,72711.201,Oregon,248770,109022,357792,,,
242,,8/19/43,8/19/43,690400,888165,56050,16198.45,1650813.45,1578565,72248.45,Oregon,245206,107380,352586,,,
243,,8/21/43,8/21/43,664894,888165,55144,15936.616,1624139.616,1553059,71080.616,Oregon,237221,103738,340959,,,
244,,8/23/43,8/23/43,672489,888165,55414,16014.646,1632082.646,1560654,71428.646,Oregon,238481,104210,342691,,,
245,,8/25/43,8/25/43,683629,888165,55809,16128.801,1643731.801,1571794,71937.801,Oregon,241495,105442,346937,,,
246,,8/26/43,8/26/43,677522,888165,55592,16066.088,1637345.088,1565687,71658.088,Oregon,238163,103838,342001,,,
247,,8/28/43,8/28/43,653759,888165,54749,15822.461,1612495.461,1541924,70571.461,Oregon,231364,100758,332122,,,
248,,8/30/43,8/30/43,657585,888165,54884,15861.476,1616495.476,1545750,70745.476,Oregon,231083,100538,331621,,,
249,,9/1/43,9/1/43,676908,888165,55570,16059.73,1636702.73,1565073,71629.73,Oregon,236582,102790,339372,,,
250,,9/2/43,9/2/43,671063,888165,55363,15999.907,1630590.907,1559228,71362.907,Oregon,233137,101135,334272,,,
251,,9/4/43,9/4/43,665404,888165,55162,15941.818,1624672.818,1553569,71103.818,Oregon,233723,101171,334894,,,
252,,9/5/43,9/5/43,655451,888165,54809,15839.801,1614264.801,1543616,70648.801,Oregon,231108,99834,330942,,,
253,,9/7/43,9/7/43,660935,888165,55003,15895.867,1619998.867,1549100,70898.867,Oregon,229287,98917,328204,,,
254,,9/9/43,9/9/43,672153,888165,55402,16011.178,1631731.178,1560318,71413.178,Oregon,213298,117449,330747,,,
255,,9/9/43,9/9/43,663237,888165,55085,15919.565,1622406.565,1551402,71004.565,Oregon,228501,97899,326400,,,
256,,9/11/43,9/11/43,641864,888165,54326,15700.214,1600055.214,1530029,70026.214,Oregon,222146,94707,316853,,,
257,,9/12/43,9/12/43,649704,888165,54605,15780.845,1608254.845,1537869,70385.845,Oregon,223443,95079,318522,,,
258,,9/13/43,9/13/43,635024,888165,54083,15629.987,1592901.987,1523189,69712.987,Oregon,215487,91398,306885,,,
259,,9/14/43,9/14/43,645842,888165,54467,15740.963,1604214.963,1534007,70207.963,Oregon,219440,92674,312114,,,
260,,9/16/43,9/16/43,645615,888165,54459,15738.651,1603977.651,1533780,70197.651,Oregon,219716,92370,312086,,,
261,,9/18/43,9/18/43,646557,888165,54493,15748.477,1604963.477,1534722,70241.477,Oregon,221854,92852,314706,,,
262,,9/19/43,9/19/43,659364,888165,54948,15879.972,1618356.972,1547529,70827.972,Oregon,225692,94269,319961,,,
263,,9/20/43,9/20/43,664821,888165,55141,15935.749,1624062.749,1552986,71076.749,Oregon,224543,93552,318095,,,
264,,9/22/43,9/22/43,645793,888165,54466,15740.674,1604164.674,1533958,70206.674,Oregon,218490,90635,309125,,,
265,,9/23/43,9/23/43,637243,888165,54162,15652.818,1595222.818,1525408,69814.818,Oregon,215187,89124,304311,,,
266,,9/24/43,9/24/43,658318,888165,54910,15868.99,1617261.99,1546483,70778.99,Oregon,224814,93015,317829,,,
267,,9/25/43,9/25/43,626439,888165,53778,15541.842,1583923.842,1514604,69319.842,Oregon,212128,87425,299553,,,
268,,9/27/43,9/27/43,626629,888165,53785,15543.865,1584122.865,1514794,69328.865,Oregon,209477,86154,295631,,,
269,,9/28/43,9/28/43,640072,888165,54263,15682.007,1598182.007,1528237,69945.007,Oregon,215584,88578,304162,,,
270,,9/29/43,9/29/43,637048,888165,54155,15650.795,1595018.795,1525213,69805.795,Oregon,215755,88727,304482,,,
271,,9/30/43,9/30/43,634610,888165,54069,15625.941,1592469.941,1522775,69694.941,Oregon,214624,88208,302832,,,
272,,9/30/43,9/30/43,643997,888165,54402,15722.178,1602286.178,1532162,70124.178,Oregon,219211,90007,309218,,,
273,,10/2/43,10/2/43,628318,888165,53845,15561.205,1585889.205,1516483,69406.205,Oregon,212821,87373,300194,,,
274,,10/4/43,10/4/43,655718,888165,54819,15842.691,1614544.691,1543883,70661.691,Oregon,223227,91912,315139,,,
275,,10/6/43,10/6/43,648638,888165,54567,15769.863,1607139.863,1536803,70336.863,Oregon,220435,91183,311618,,,
276,,10/8/43,10/8/43,644952,888165,54436,15732.004,1603285.004,1533117,70168.004,Oregon,219217,91227,310444,,,
277,,10/10/43,10/10/43,668283,888165,55264,15971.296,1627683.296,1556448,71235.296,Oregon,230534,96577,327111,,,
278,,10/12/43,10/12/43,624408,888165,53706,15521.034,1581800.034,1512573,69227.034,Oregon,211167,90573,301740,,,
279,,10/14/43,10/14/43,626921,888165,53796,15547.044,1584429.044,1515086,69343.044,Oregon,211558,91480,303038,,,
280,,10/16/43,10/16/43,609626,888165,53182,15369.598,1566342.598,1497791,68551.598,Oregon,204901,89149,294050,,,
281,,10/17/43,10/17/43,629015,888165,53870,15568.43,1586618.43,1517180,69438.43,Oregon,213517,93194,306711,,,
282,,10/19/43,10/19/43,630114,888165,53909,15579.701,1587767.701,1518279,69488.701,Oregon,212426,93252,305678,,,
283,,10/21/43,10/21/43,613763,888165,53328,15411.792,1570667.792,1501928,68739.792,Oregon,206556,91174,297730,,,
284,,10/23/43,10/23/43,607913,888165,53121,15351.969,1564550.969,1496078,68472.969,Oregon,204684,90855,295539,,,
285,,10/24/43,10/24/43,603097,888165,52950,15302.55,1559514.55,1491262,68252.55,Oregon,204392,91281,295673,,,
286,,10/26/43,10/26/43,628172,888165,53840,15559.76,1585736.76,1516337,69399.76,Oregon,213559,95828,309387,,,
287,,10/28/43,10/28/43,629632,888165,53892,15574.788,1587263.788,1517797,69466.788,Oregon,212350,95766,308116,,,
288,,10/29/43,10/29/43,619493,888165,53532,15470.748,1576660.748,1507658,69002.748,Oregon,209085,94984,304069,,,
289,,10/31/43,10/31/43,623778,888165,53684,15514.676,1581141.676,1511943,69198.676,Oregon,213716,97696,311412,,,
290,,11/2/43,11/2/43,639563,888165,54244,15676.516,1597648.516,1527728,69920.516,Oregon,218956,100432,319388,,,
291,,11/4/43,11/4/43,632552,888165,53996,15604.844,1590317.844,1520717,69600.844,Oregon,215211,99051,314262,,,
292,,11/6/43,11/6/43,626899,888165,53795,15546.755,1584405.755,1515064,69341.755,Oregon,212011,98018,310029,,,
293,,11/8/43,11/8/43,632784,888165,54004,15607.156,1590560.156,1520949,69611.156,Oregon,216587,100493,317080,,,
294,,11/10/43,11/10/43,656581,888165,54849,15851.361,1615446.361,1544746,70700.361,Oregon,226405,105212,331617,,,
295,,11/12/43,11/12/43,632722,888165,54002,15606.578,1590495.578,1520887,69608.578,Oregon,216478,100833,317311,,,
296,,11/14/43,11/14/43,656793,888165,54856,15853.384,1615667.384,1544958,70709.384,Oregon,224834,104907,329741,,,
297,,11/16/43,11/16/43,660468,888165,54987,15891.243,1619511.243,1548633,70878.243,Oregon,226313,105818,332131,,,
298,,11/18/43,11/18/43,678683,888165,55634,16078.226,1638560.226,1566848,71712.226,Oregon,233755,109467,343222,,,
299,,11/20/43,11/20/43,687883,888165,55960,16172.44,1648180.44,1576048,72132.44,Oregon,236862,111178,348040,,,
300,,11/22/43,11/22/43,653787,888165,54750,15822.75,1612524.75,1541952,70572.75,Oregon,222923,104871,327794,,,
301,,11/24/43,11/24/43,658302,888165,54910,15868.99,1617245.99,1546467,70778.99,Oregon,224324,105691,330015,,,
302,,11/24/43,11/24/43,671961,888165,55395,16009.155,1631530.155,1560126,71404.155,Oregon,229956,108478,338434,,,
303,,11/28/43,11/28/43,670726,888165,55351,15996.439,1630238.439,1558891,71347.439,Oregon,228498,108177,336675,,,
304,,12/1/43,12/1/43,661119,888165,55010,15897.89,1620191.89,1549284,70907.89,Oregon,223252,105930,329182,,,
305,,12/3/43,12/3/43,671175,888165,55367,16001.063,1630708.063,1559340,71368.063,Oregon,230160,109454,339614,,,
306,,12/5/43,12/5/43,676857,888165,55569,16059.441,1636650.441,1565022,71628.441,Oregon,230960,109932,340892,,,
307,,12/7/43,12/7/43,670845,888165,55355,15997.595,1630362.595,1559010,71352.595,Oregon,226931,108302,335233,,,
308,,12/9/43,12/9/43,660048,888165,54972,15886.908,1619071.908,1548213,70858.908,Oregon,224921,107629,332550,,,
309,,12/11/43,12/11/43,663901,888165,55109,15926.501,1623101.501,1552066,71035.501,Oregon,227170,108927,336097,,,
310,,12/13/43,12/13/43,683563,888165,55807,16128.223,1643663.223,1571728,71935.223,Oregon,232458,111474,343932,,,
311,,12/15/43,12/15/43,709316,888165,56721,16392.369,1670594.369,1597481,73113.369,Oregon,242163,116459,358622,,,
312,,12/17/43,12/17/43,675812,888165,55532,16048.748,1635557.748,1563977,71580.748,Oregon,230785,111112,341897,,,
313,,12/19/43,12/19/43,696565,888165,56268,16261.452,1657259.452,1584730,72529.452,Oregon,241636,116515,358151,,,
314,,12/21/43,12/21/43,707857,888165,56669,16377.341,1669068.341,1596022,73046.341,Oregon,246286,118870,365156,,,
315,,12/23/43,12/23/43,728989,888165,57416,16593.224,1691163.224,1617154,74009.224,Oregon,254339,123082,377421,,,
316,,12/27/43,12/27/43,703304,888165,56508,16330.812,1664307.812,1591469,72838.812,Oregon,246320,119334,365654,,,
317,,12/29/43,12/29/43,703407,888165,56511,16331.679,1664414.679,1591572,72842.679,Oregon,246153,119502,365655,,,
318,,12/31/43,12/31/43,703416,888165,56512,16331.968,1664424.968,1591581,72843.968,Oregon,244740,119008,363748,,,
319,,12/31/43,12/31/43,725608,888165,57300,16559.7,1687632.7,1613773,73859.7,Oregon,253254,123551,376805,,,
320,,1/4/44,1/4/44,722061,888165,57174,16523.286,1683923.286,1610226,73697.286,Oregon,252985,123828,376813,,,
321,,1/6/44,1/6/44,772298,888165,58957,17038.573,1736458.573,1660463,75995.573,Oregon,270888,132878,403766,,,
322,,1/7/44,1/7/44,839362,888165,61339,17726.971,1806592.971,1727527,79065.971,Oregon,297237,146240,443477,,,
323,,1/8/44,1/8/44,812278,888165,60377,17448.953,1778268.953,1700443,77825.953,Oregon,287064,141809,428873,,,
324,,1/12/44,1/12/44,841091,888165,61400,17744.6,1808400.6,1729256,79144.6,Oregon,297040,147134,444174,,,
325,,1/15/44,1/15/44,829913,888165,61003,17629.867,1796710.867,1718078,78632.867,Oregon,292776,145263,438039,,,
326,,1/18/44,1/18/44,858270,888165,62010,17920.89,1826365.89,1746435,79930.89,Oregon,301136,149799,450935,,,
327,,1/22/44,1/22/44,1001078,888165,67081,19386.409,1975710.409,1889243,86467.409,Oregon,360394,179873,540267,,,
328,,1/29/44,1/29/44,921483,888165,64255,18569.695,1892472.695,1809648,82824.695,Oregon,325619,162708,488327,,,
329,,2/2/44,2/2/44,881081,888165,62820,18154.98,1850220.98,1769246,80974.98,Oregon,309558,154681,464239,,,
330,,2/4/44,2/4/44,994324,888165,66841,19317.049,1968647.049,1882489,86158.049,Oregon,353210,176888,530098,,,